DateTime,CarCount,BikeCount,BusCount,TruckCount,Total,Traffic Situation,Traffic_Numerical
2015-10-10 00:00:00,31,0,4,4,39,low,1
2015-10-10 00:15:00,49,0,3,3,55,low,1
2015-10-10 00:30:00,46,0,3,6,55,low,1
2015-10-10 00:45:00,51,0,2,5,58,low,1
2015-10-10 01:00:00,57,6,15,16,94,normal,2
2015-10-10 01:15:00,44,0,5,4,53,low,1
2015-10-10 01:30:00,37,0,1,4,42,low,1
2015-10-10 01:45:00,42,4,4,5,55,low,1
2015-10-10 02:00:00,51,0,9,7,67,low,1
2015-10-10 02:15:00,34,0,4,7,45,low,1
2015-10-10 02:30:00,45,0,1,1,47,low,1
2015-10-10 02:45:00,45,0,1,3,49,low,1
2015-10-10 03:00:00,50,0,3,0,53,low,1
2015-10-10 03:15:00,34,0,4,4,42,low,1
2015-10-10 03:30:00,129,22,42,1,194,heavy,4
2015-10-10 03:45:00,144,16,49,0,209,heavy,4
2015-10-10 04:00:00,111,28,20,3,162,normal,2
2015-10-10 04:15:00,67,11,10,16,104,normal,2
2015-10-10 04:30:00,65,24,7,16,112,normal,2
2015-10-10 04:45:00,94,27,7,16,144,normal,2
2015-10-10 05:00:00,94,20,8,7,129,normal,2
2015-10-10 05:15:00,67,29,5,10,111,low,1
2015-10-10 05:30:00,56,12,2,14,84,normal,2
2015-10-10 05:45:00,57,13,3,11,84,low,1
2015-10-10 06:00:00,129,22,42,1,194,heavy,4
2015-10-10 06:15:00,144,16,49,0,209,heavy,4
2015-10-10 06:30:00,111,28,20,3,162,normal,2
2015-10-10 06:45:00,120,27,46,3,196,heavy,4
2015-10-10 07:00:00,102,39,47,1,189,heavy,4
2015-10-10 07:15:00,145,23,27,0,195,heavy,4
2015-10-10 07:30:00,114,37,21,5,177,heavy,4
2015-10-10 07:45:00,108,18,22,1,149,normal,2
2015-10-10 08:00:00,122,28,33,1,184,heavy,4
2015-10-10 08:15:00,114,39,30,3,186,heavy,4
2015-10-10 08:30:00,150,36,25,1,212,heavy,4
2015-10-10 08:45:00,107,10,49,2,168,heavy,4
2015-10-10 09:00:00,124,24,22,0,170,heavy,4
2015-10-10 09:15:00,77,16,39,29,161,high,3
2015-10-10 09:30:00,15,23,30,21,89,normal,2
2015-10-10 09:45:00,32,22,38,21,113,high,3
2015-10-10 10:00:00,68,13,29,24,134,high,3
2015-10-10 10:15:00,27,16,36,30,109,normal,2
2015-10-10 10:30:00,76,7,11,15,109,normal,2
2015-10-10 10:45:00,41,23,20,17,101,normal,2
2015-10-10 11:00:00,33,10,3,29,75,normal,2
2015-10-10 11:15:00,58,8,14,29,109,normal,2
2015-10-10 11:30:00,65,7,11,26,109,normal,2
2015-10-10 11:45:00,47,9,6,29,91,normal,2
2015-10-10 12:00:00,38,10,5,25,78,normal,2
2015-10-10 12:15:00,57,8,12,29,106,normal,2
2015-10-10 12:30:00,20,6,4,20,50,normal,2
2015-10-10 12:45:00,24,9,14,23,70,normal,2
2015-10-10 13:00:00,52,10,13,21,96,normal,2
2015-10-10 13:15:00,79,15,36,18,148,high,3
2015-10-10 13:30:00,84,24,22,18,148,normal,2
2015-10-10 13:45:00,59,19,35,16,129,high,3
2015-10-10 14:00:00,88,26,31,19,164,high,3
2015-10-10 14:15:00,24,11,32,13,80,normal,2
2015-10-10 14:30:00,110,17,23,20,170,heavy,4
2015-10-10 14:45:00,29,26,5,6,66,low,1
2015-10-10 15:00:00,43,26,11,20,100,normal,2
2015-10-10 15:15:00,68,28,9,15,120,normal,2
2015-10-10 15:30:00,108,16,8,18,150,normal,2
2015-10-10 15:45:00,101,26,8,14,149,normal,2
2015-10-10 16:00:00,141,31,36,6,214,heavy,4
2015-10-10 16:15:00,120,25,28,5,178,heavy,4
2015-10-10 16:30:00,137,23,44,5,209,heavy,4
2015-10-10 16:45:00,124,11,30,7,172,heavy,4
2015-10-10 17:00:00,145,25,49,7,226,heavy,4
2015-10-10 17:15:00,122,37,23,8,190,heavy,4
2015-10-10 17:30:00,136,30,20,9,195,heavy,4
2015-10-10 17:45:00,145,18,40,9,212,heavy,4
2015-10-10 18:00:00,138,34,28,5,205,heavy,4
2015-10-10 18:15:00,123,10,29,8,170,heavy,4
2015-10-10 18:30:00,105,15,21,9,150,normal,2
2015-10-10 18:45:00,75,22,20,11,128,normal,2
2015-10-10 19:00:00,90,12,10,13,125,normal,2
2015-10-10 19:15:00,102,22,20,16,160,normal,2
2015-10-10 19:30:00,61,18,15,27,121,high,3
2015-10-10 19:45:00,70,8,14,6,98,low,1
2015-10-10 20:00:00,80,17,12,34,143,high,3
2015-10-10 20:15:00,62,12,14,19,107,normal,2
2015-10-10 20:30:00,96,5,11,13,125,normal,2
2015-10-10 20:45:00,102,6,12,13,133,normal,2
2015-10-10 21:00:00,91,14,15,6,126,normal,2
2015-10-10 21:15:00,95,8,17,13,133,normal,2
2015-10-10 21:30:00,75,15,12,21,123,high,3
2015-10-10 21:45:00,53,21,20,10,104,normal,2
2015-10-10 22:00:00,13,1,0,19,33,normal,2
2015-10-10 22:15:00,10,0,1,24,35,normal,2
2015-10-10 22:30:00,16,2,0,33,51,normal,2
2015-10-10 22:45:00,11,1,0,29,41,normal,2
2015-10-10 23:00:00,18,2,1,13,34,normal,2
2015-10-10 23:15:00,15,0,1,11,27,low,1
2015-10-10 23:30:00,14,1,0,33,48,normal,2
2015-10-10 23:45:00,17,2,0,22,41,normal,2
2015-10-11 00:00:00,12,2,1,17,32,normal,2
2015-10-11 00:15:00,18,0,0,29,47,normal,2
2015-10-11 00:30:00,16,1,0,14,31,normal,2
2015-10-11 00:45:00,20,0,0,14,34,normal,2
2015-10-11 01:00:00,20,1,1,30,52,normal,2
2015-10-11 01:15:00,15,0,1,23,39,normal,2
2015-10-11 01:30:00,16,0,1,26,43,normal,2
2015-10-11 01:45:00,18,4,0,11,33,low,1
2015-10-11 02:00:00,17,3,1,36,57,normal,2
2015-10-11 02:15:00,14,4,1,10,29,low,1
2015-10-11 02:30:00,18,2,1,25,46,normal,2
2015-10-11 02:45:00,12,2,0,19,33,normal,2
2015-10-11 03:00:00,11,4,0,30,45,normal,2
2015-10-11 03:15:00,19,1,1,36,57,normal,2
2015-10-11 03:30:00,10,4,0,36,50,normal,2
2015-10-11 03:45:00,20,1,1,32,54,normal,2
2015-10-11 04:00:00,15,5,1,40,61,normal,2
2015-10-11 04:15:00,104,6,5,1,116,normal,2
2015-10-11 04:30:00,109,25,3,8,145,normal,2
2015-10-11 04:45:00,82,23,8,20,133,normal,2
2015-10-11 05:00:00,81,25,1,18,125,normal,2
2015-10-11 05:15:00,95,16,10,1,122,normal,2
2015-10-11 05:30:00,91,24,7,6,128,normal,2
2015-10-11 05:45:00,81,30,10,0,121,normal,2
2015-10-11 06:00:00,125,13,26,2,166,high,3
2015-10-11 06:15:00,125,39,49,3,216,heavy,4
2015-10-11 06:30:00,125,34,37,1,197,heavy,4
2015-10-11 06:45:00,125,19,25,4,173,heavy,4
2015-10-11 07:00:00,125,15,49,0,189,heavy,4
2015-10-11 07:15:00,125,32,50,5,212,heavy,4
2015-10-11 07:30:00,125,38,50,1,214,heavy,4
2015-10-11 07:45:00,125,29,29,3,186,heavy,4
2015-10-11 08:00:00,125,31,48,4,208,heavy,4
2015-10-11 08:15:00,125,32,50,0,207,heavy,4
2015-10-11 08:30:00,125,31,45,0,201,heavy,4
2015-10-11 08:45:00,125,21,20,1,167,normal,2
2015-10-11 09:00:00,125,28,36,0,189,heavy,4
2015-10-11 09:15:00,39,10,37,16,102,normal,2
2015-10-11 09:30:00,89,8,12,13,122,normal,2
2015-10-11 09:45:00,51,16,16,13,96,normal,2
2015-10-11 10:00:00,17,9,18,28,72,normal,2
2015-10-11 10:15:00,48,25,36,21,130,high,3
2015-10-11 10:30:00,93,7,30,16,146,high,3
2015-10-11 10:45:00,55,15,36,15,121,high,3
2015-10-11 11:00:00,51,10,8,22,91,normal,2
2015-10-11 11:15:00,51,7,3,24,85,normal,2
2015-10-11 11:30:00,51,9,7,30,97,normal,2
2015-10-11 11:45:00,51,7,14,20,92,normal,2
2015-10-11 12:00:00,51,10,14,20,95,normal,2
2015-10-11 12:15:00,51,10,6,22,89,normal,2
2015-10-11 12:30:00,51,8,11,22,92,normal,2
2015-10-11 12:45:00,51,6,10,26,93,normal,2
2015-10-11 13:00:00,51,7,7,27,92,normal,2
2015-10-11 13:15:00,104,17,25,20,166,normal,2
2015-10-11 13:30:00,6,28,27,14,75,normal,2
2015-10-11 13:45:00,54,29,37,9,129,high,3
2015-10-11 14:00:00,43,13,30,20,106,normal,2
2015-10-11 14:15:00,60,21,26,11,118,high,3
2015-10-11 14:30:00,101,23,8,20,152,normal,2
2015-10-11 14:45:00,62,26,19,11,118,normal,2
2015-10-11 15:00:00,39,24,13,11,87,low,1
2015-10-11 15:15:00,90,20,35,7,152,high,3
2015-10-11 15:30:00,109,30,22,20,181,heavy,4
2015-10-11 15:45:00,68,26,25,20,139,normal,2
2015-10-11 16:00:00,142,22,37,6,207,heavy,4
2015-10-11 16:15:00,113,14,20,5,152,normal,2
2015-10-11 16:30:00,142,13,37,8,200,heavy,4
2015-10-11 16:45:00,108,23,26,9,166,high,3
2015-10-11 17:00:00,122,29,30,7,188,heavy,4
2015-10-11 17:15:00,133,12,30,7,182,heavy,4
2015-10-11 17:30:00,118,23,38,10,189,heavy,4
2015-10-11 17:45:00,121,35,26,8,190,heavy,4
2015-10-11 18:00:00,116,23,20,8,167,normal,2
2015-10-11 18:15:00,132,12,27,8,179,heavy,4
2015-10-11 18:30:00,144,17,33,7,201,heavy,4
2015-10-11 18:45:00,103,21,11,11,146,normal,2
2015-10-11 19:00:00,107,15,10,15,147,normal,2
2015-10-11 19:15:00,50,10,10,17,87,normal,2
2015-10-11 19:30:00,108,15,10,6,139,normal,2
2015-10-11 19:45:00,108,24,15,29,176,heavy,4
2015-10-11 20:00:00,101,6,15,13,135,normal,2
2015-10-11 20:15:00,55,17,12,19,103,normal,2
2015-10-11 20:30:00,77,7,20,16,120,normal,2
2015-10-11 20:45:00,91,12,19,8,130,normal,2
2015-10-11 21:00:00,95,25,17,29,166,high,3
2015-10-11 21:15:00,78,17,17,27,139,high,3
2015-10-11 21:30:00,98,16,16,21,151,high,3
2015-10-11 21:45:00,86,13,11,35,145,high,3
2015-10-11 22:00:00,18,4,0,16,38,normal,2
2015-10-11 22:15:00,18,5,0,12,35,low,1
2015-10-11 22:30:00,18,2,1,25,46,normal,2
2015-10-11 22:45:00,18,1,0,17,36,normal,2
2015-10-11 23:00:00,18,5,0,21,44,normal,2
2015-10-11 23:15:00,18,0,1,12,31,low,1
2015-10-11 23:30:00,18,3,1,28,50,normal,2
2015-10-11 23:45:00,18,4,1,40,63,normal,2
2015-10-12 00:00:00,18,1,1,39,59,normal,2
2015-10-12 00:15:00,18,4,0,30,52,normal,2
2015-10-12 00:30:00,18,5,1,13,37,normal,2
2015-10-12 00:45:00,18,2,0,37,57,normal,2
2015-10-12 01:00:00,18,0,0,13,31,normal,2
2015-10-12 01:15:00,18,5,0,11,34,low,1
2015-10-12 01:30:00,18,5,1,12,36,low,1
2015-10-12 01:45:00,18,1,1,16,36,normal,2
2015-10-12 02:00:00,18,1,1,34,54,normal,2
2015-10-12 02:15:00,18,1,0,24,43,normal,2
2015-10-12 02:30:00,18,0,0,23,41,normal,2
2015-10-12 02:45:00,18,0,0,27,45,normal,2
2015-10-12 03:00:00,18,5,0,28,51,normal,2
2015-10-12 03:15:00,18,1,0,14,33,normal,2
2015-10-12 03:30:00,18,5,0,25,48,normal,2
2015-10-12 03:45:00,18,4,1,30,53,normal,2
2015-10-12 04:00:00,18,5,1,30,54,normal,2
2015-10-12 04:15:00,62,24,7,2,95,low,1
2015-10-12 04:30:00,51,23,6,1,81,low,1
2015-10-12 04:45:00,114,23,10,19,166,normal,2
2015-10-12 05:00:00,85,22,9,9,125,normal,2
2015-10-12 05:15:00,102,24,4,20,150,normal,2
2015-10-12 05:30:00,101,18,3,17,139,normal,2
2015-10-12 05:45:00,116,19,0,17,152,normal,2
2015-10-12 06:00:00,117,38,50,5,210,heavy,4
2015-10-12 06:15:00,114,32,34,2,182,heavy,4
2015-10-12 06:30:00,120,17,23,1,161,normal,2
2015-10-12 06:45:00,145,20,25,2,192,heavy,4
2015-10-12 07:00:00,125,30,48,1,204,heavy,4
2015-10-12 07:15:00,103,27,45,1,176,heavy,4
2015-10-12 07:30:00,114,20,43,1,178,heavy,4
2015-10-12 07:45:00,145,10,44,1,200,heavy,4
2015-10-12 08:00:00,147,31,20,4,202,heavy,4
2015-10-12 08:15:00,104,24,40,0,168,heavy,4
2015-10-12 08:30:00,124,11,22,0,157,normal,2
2015-10-12 08:45:00,101,37,31,4,173,heavy,4
2015-10-12 09:00:00,144,30,37,1,212,heavy,4
2015-10-12 09:15:00,24,18,37,18,97,normal,2
2015-10-12 09:30:00,24,8,17,25,74,normal,2
2015-10-12 09:45:00,16,22,12,20,70,normal,2
2015-10-12 10:00:00,26,2,39,26,93,normal,2
2015-10-12 10:15:00,90,7,18,15,130,normal,2
2015-10-12 10:30:00,59,6,11,11,87,low,1
2015-10-12 10:45:00,28,7,22,18,75,normal,2
2015-10-12 11:00:00,60,5,14,21,100,normal,2
2015-10-12 11:15:00,69,9,8,23,109,normal,2
2015-10-12 11:30:00,59,9,12,26,106,normal,2
2015-10-12 11:45:00,24,10,5,21,60,normal,2
2015-10-12 12:00:00,41,7,7,21,76,normal,2
2015-10-12 12:15:00,48,10,9,29,96,normal,2
2015-10-12 12:30:00,59,10,14,23,106,normal,2
2015-10-12 12:45:00,67,7,12,28,114,high,3
2015-10-12 13:00:00,52,9,8,20,89,normal,2
2015-10-12 13:15:00,45,26,29,10,110,normal,2
2015-10-12 13:30:00,14,21,7,18,60,normal,2
2015-10-12 13:45:00,55,22,24,10,111,normal,2
2015-10-12 14:00:00,45,14,39,5,103,normal,2
2015-10-12 14:15:00,90,17,16,11,134,normal,2
2015-10-12 14:30:00,33,21,25,5,84,normal,2
2015-10-12 14:45:00,118,25,31,13,187,heavy,4
2015-10-12 15:00:00,86,28,13,5,132,normal,2
2015-10-12 15:15:00,105,29,22,12,168,heavy,4
2015-10-12 15:30:00,10,19,26,8,63,normal,2
2015-10-12 15:45:00,46,22,18,9,95,normal,2
2015-10-12 16:00:00,105,35,48,6,194,heavy,4
2015-10-12 16:15:00,135,37,34,5,211,heavy,4
2015-10-12 16:30:00,103,29,44,6,182,heavy,4
2015-10-12 16:45:00,113,13,42,10,178,heavy,4
2015-10-12 17:00:00,103,20,27,9,159,high,3
2015-10-12 17:15:00,150,13,20,9,192,heavy,4
2015-10-12 17:30:00,116,25,33,8,182,heavy,4
2015-10-12 17:45:00,109,16,41,9,175,heavy,4
2015-10-12 18:00:00,112,11,50,5,178,heavy,4
2015-10-12 18:15:00,104,31,30,5,170,heavy,4
2015-10-12 18:30:00,146,18,40,6,210,heavy,4
2015-10-12 18:45:00,110,24,10,29,173,heavy,4
2015-10-12 19:00:00,60,15,12,25,112,high,3
2015-10-12 19:15:00,103,9,14,29,155,high,3
2015-10-12 19:30:00,102,6,15,6,129,normal,2
2015-10-12 19:45:00,51,17,16,8,92,normal,2
2015-10-12 20:00:00,62,12,11,18,103,normal,2
2015-10-12 20:15:00,103,14,12,5,134,normal,2
2015-10-12 20:30:00,50,7,11,23,91,normal,2
2015-10-12 20:45:00,80,14,20,6,120,normal,2
2015-10-12 21:00:00,98,13,18,21,150,high,3
2015-10-12 21:15:00,53,25,20,13,111,normal,2
2015-10-12 21:30:00,52,8,10,27,97,normal,2
2015-10-12 21:45:00,71,23,13,21,128,high,3
2015-10-12 22:00:00,17,3,0,29,49,normal,2
2015-10-12 22:15:00,20,5,1,36,62,normal,2
2015-10-12 22:30:00,15,0,0,32,47,normal,2
2015-10-12 22:45:00,15,0,1,20,36,normal,2
2015-10-12 23:00:00,14,2,0,23,39,normal,2
2015-10-12 23:15:00,13,1,0,29,43,normal,2
2015-10-12 23:30:00,14,5,0,31,50,normal,2
2015-10-12 23:45:00,16,3,0,33,52,normal,2
2015-10-13 00:00:00,18,4,1,15,38,normal,2
2015-10-13 00:15:00,20,0,1,23,44,normal,2
2015-10-13 00:30:00,19,3,0,16,38,normal,2
2015-10-13 00:45:00,10,3,0,12,25,low,1
2015-10-13 01:00:00,10,4,0,23,37,normal,2
2015-10-13 01:15:00,12,5,0,29,46,normal,2
2015-10-13 01:30:00,10,0,0,39,49,normal,2
2015-10-13 01:45:00,16,2,1,21,40,normal,2
2015-10-13 02:00:00,18,4,1,36,59,normal,2
2015-10-13 02:15:00,15,1,0,14,30,normal,2
2015-10-13 02:30:00,17,4,0,13,34,normal,2
2015-10-13 02:45:00,18,3,1,24,46,normal,2
2015-10-13 03:00:00,19,2,0,11,32,low,1
2015-10-13 03:15:00,19,3,0,21,43,normal,2
2015-10-13 03:30:00,19,3,1,31,54,normal,2
2015-10-13 03:45:00,14,2,1,19,36,normal,2
2015-10-13 04:00:00,11,0,0,27,38,normal,2
2015-10-13 04:15:00,27,6,1,11,45,low,1
2015-10-13 04:30:00,33,11,6,13,63,normal,2
2015-10-13 04:45:00,63,6,7,10,86,low,1
2015-10-13 05:00:00,58,13,4,15,90,normal,2
2015-10-13 05:15:00,57,11,7,10,85,low,1
2015-10-13 05:30:00,63,10,6,12,91,low,1
2015-10-13 05:45:00,74,9,0,15,98,normal,2
2015-10-13 06:00:00,71,9,7,10,97,low,1
2015-10-13 06:15:00,33,9,6,13,61,normal,2
2015-10-13 06:30:00,29,6,1,12,48,low,1
2015-10-13 06:45:00,32,9,3,11,55,low,1
2015-10-13 07:00:00,57,14,3,11,85,low,1
2015-10-13 07:15:00,31,11,0,14,56,normal,2
2015-10-13 07:30:00,30,9,3,10,52,low,1
2015-10-13 07:45:00,61,8,7,12,88,low,1
2015-10-13 08:00:00,47,10,4,10,71,low,1
2015-10-13 08:15:00,80,16,4,15,115,normal,2
2015-10-13 08:30:00,49,10,2,10,71,low,1
2015-10-13 08:45:00,58,7,5,13,83,normal,2
2015-10-13 09:00:00,53,19,1,10,83,low,1
2015-10-13 09:15:00,132,47,25,0,204,heavy,4
2015-10-13 09:30:00,131,52,15,0,198,heavy,4
2015-10-13 09:45:00,171,59,27,3,260,heavy,4
2015-10-13 10:00:00,131,43,20,3,197,heavy,4
2015-10-13 10:15:00,177,56,12,4,249,heavy,4
2015-10-13 10:30:00,160,47,30,3,240,heavy,4
2015-10-13 10:45:00,178,68,28,4,278,heavy,4
2015-10-13 11:00:00,169,70,20,3,262,heavy,4
2015-10-13 11:15:00,133,56,25,2,216,heavy,4
2015-10-13 11:30:00,151,52,13,0,216,heavy,4
2015-10-13 11:45:00,179,46,27,3,255,heavy,4
2015-10-13 12:00:00,144,68,20,0,232,heavy,4
2015-10-13 12:15:00,162,46,19,2,229,heavy,4
2015-10-13 12:30:00,159,44,23,2,228,heavy,4
2015-10-13 12:45:00,174,67,30,1,272,heavy,4
2015-10-13 13:00:00,136,57,29,4,226,heavy,4
2015-10-13 13:15:00,156,42,12,3,213,heavy,4
2015-10-13 13:30:00,175,63,19,3,260,heavy,4
2015-10-13 13:45:00,172,62,20,2,256,heavy,4
2015-10-13 14:00:00,171,49,15,0,235,heavy,4
2015-10-13 14:15:00,172,65,18,2,257,heavy,4
2015-10-13 14:30:00,176,50,13,1,240,heavy,4
2015-10-13 14:45:00,153,50,23,3,229,heavy,4
2015-10-13 15:00:00,148,64,27,0,239,heavy,4
2015-10-13 15:15:00,56,28,6,2,92,low,1
2015-10-13 15:30:00,88,26,25,0,139,normal,2
2015-10-13 15:45:00,82,23,14,0,119,normal,2
2015-10-13 16:00:00,77,20,7,0,104,low,1
2015-10-13 16:15:00,66,24,1,0,91,low,1
2015-10-13 16:30:00,72,22,8,2,104,low,1
2015-10-13 16:45:00,62,28,21,2,113,normal,2
2015-10-13 17:00:00,66,26,4,1,97,low,1
2015-10-13 17:15:00,85,20,4,0,109,low,1
2015-10-13 17:30:00,87,24,11,2,124,normal,2
2015-10-13 17:45:00,67,28,25,0,120,normal,2
2015-10-13 18:00:00,70,26,16,2,114,normal,2
2015-10-13 18:15:00,62,20,20,1,103,normal,2
2015-10-13 18:30:00,67,29,1,0,97,low,1
2015-10-13 18:45:00,65,25,1,1,92,low,1
2015-10-13 19:00:00,76,24,23,0,123,normal,2
2015-10-13 19:15:00,42,1,5,11,59,low,1
2015-10-13 19:30:00,42,10,3,1,56,low,1
2015-10-13 19:45:00,31,11,1,12,55,low,1
2015-10-13 20:00:00,47,7,3,6,63,low,1
2015-10-13 20:15:00,28,7,2,4,41,low,1
2015-10-13 20:30:00,22,3,6,1,32,low,1
2015-10-13 20:45:00,29,1,7,5,42,low,1
2015-10-13 21:00:00,43,9,1,11,64,low,1
2015-10-13 21:15:00,23,3,3,8,37,low,1
2015-10-13 21:30:00,21,2,5,15,43,normal,2
2015-10-13 21:45:00,31,2,1,9,43,low,1
2015-10-13 22:00:00,15,5,0,18,38,normal,2
2015-10-13 22:15:00,11,2,0,15,28,normal,2
2015-10-13 22:30:00,12,0,1,17,30,normal,2
2015-10-13 22:45:00,18,3,0,18,39,normal,2
2015-10-13 23:00:00,19,1,0,31,51,normal,2
2015-10-13 23:15:00,17,0,0,22,39,normal,2
2015-10-13 23:30:00,15,5,0,14,34,normal,2
2015-10-13 23:45:00,15,1,1,24,41,normal,2
2015-10-14 00:00:00,18,4,0,33,55,normal,2
2015-10-14 00:15:00,14,4,0,34,52,normal,2
2015-10-14 00:30:00,14,0,1,19,34,normal,2
2015-10-14 00:45:00,19,3,0,36,58,normal,2
2015-10-14 01:00:00,10,4,1,21,36,normal,2
2015-10-14 01:15:00,19,1,0,19,39,normal,2
2015-10-14 01:30:00,18,5,0,26,49,normal,2
2015-10-14 01:45:00,17,1,1,25,44,normal,2
2015-10-14 02:00:00,20,2,0,12,34,low,1
2015-10-14 02:15:00,15,5,0,15,35,normal,2
2015-10-14 02:30:00,11,4,0,14,29,normal,2
2015-10-14 02:45:00,14,3,1,18,36,normal,2
2015-10-14 03:00:00,13,2,0,39,54,normal,2
2015-10-14 03:15:00,17,5,0,29,51,normal,2
2015-10-14 03:30:00,13,5,0,31,49,normal,2
2015-10-14 03:45:00,18,5,0,35,58,normal,2
2015-10-14 04:00:00,15,4,0,16,35,normal,2
2015-10-14 04:15:00,55,15,5,3,78,low,1
2015-10-14 04:30:00,76,10,7,9,102,low,1
2015-10-14 04:45:00,98,0,9,19,126,normal,2
2015-10-14 05:00:00,98,12,6,6,122,normal,2
2015-10-14 05:15:00,103,2,10,20,135,normal,2
2015-10-14 05:30:00,93,17,8,12,130,normal,2
2015-10-14 05:45:00,115,27,9,16,167,normal,2
2015-10-14 06:00:00,120,12,22,3,157,normal,2
2015-10-14 06:15:00,142,18,27,0,187,heavy,4
2015-10-14 06:30:00,117,29,49,2,197,heavy,4
2015-10-14 06:45:00,126,36,24,0,186,heavy,4
2015-10-14 07:00:00,110,39,38,5,192,heavy,4
2015-10-14 07:15:00,149,20,39,5,213,heavy,4
2015-10-14 07:30:00,109,29,23,5,166,normal,2
2015-10-14 07:45:00,124,34,24,4,186,heavy,4
2015-10-14 08:00:00,149,35,32,1,217,heavy,4
2015-10-14 08:15:00,125,32,38,4,199,heavy,4
2015-10-14 08:30:00,101,23,38,1,163,high,3
2015-10-14 08:45:00,137,36,30,0,203,heavy,4
2015-10-14 09:00:00,139,15,21,3,178,heavy,4
2015-10-14 09:15:00,19,3,29,9,60,normal,2
2015-10-14 09:30:00,13,11,39,7,70,normal,2
2015-10-14 09:45:00,31,2,29,27,89,normal,2
2015-10-14 10:00:00,18,24,21,22,85,normal,2
2015-10-14 10:15:00,26,12,14,13,65,normal,2
2015-10-14 10:30:00,31,15,13,28,87,normal,2
2015-10-14 10:45:00,12,22,8,11,53,low,1
2015-10-14 11:00:00,54,5,13,23,95,normal,2
2015-10-14 11:15:00,59,7,13,21,100,normal,2
2015-10-14 11:30:00,58,8,6,23,95,normal,2
2015-10-14 11:45:00,53,8,9,25,95,normal,2
2015-10-14 12:00:00,54,7,7,20,88,normal,2
2015-10-14 12:15:00,39,10,4,29,82,normal,2
2015-10-14 12:30:00,38,9,8,22,77,normal,2
2015-10-14 12:45:00,36,5,10,23,74,normal,2
2015-10-14 13:00:00,68,6,12,24,110,normal,2
2015-10-14 13:15:00,50,18,26,14,108,normal,2
2015-10-14 13:30:00,120,28,22,20,190,heavy,4
2015-10-14 13:45:00,60,14,28,9,111,normal,2
2015-10-14 14:00:00,105,14,8,19,146,normal,2
2015-10-14 14:15:00,89,27,18,8,142,normal,2
2015-10-14 14:30:00,28,17,31,10,86,normal,2
2015-10-14 14:45:00,79,14,23,6,122,normal,2
2015-10-14 15:00:00,15,11,30,14,70,normal,2
2015-10-14 15:15:00,77,27,23,18,145,normal,2
2015-10-14 15:30:00,19,14,24,6,63,normal,2
2015-10-14 15:45:00,79,13,28,7,127,high,3
2015-10-14 16:00:00,114,10,22,9,155,normal,2
2015-10-14 16:15:00,150,30,22,5,207,heavy,4
2015-10-14 16:30:00,142,23,25,7,197,heavy,4
2015-10-14 16:45:00,111,36,25,6,178,heavy,4
2015-10-14 17:00:00,143,37,38,8,226,heavy,4
2015-10-14 17:15:00,120,37,43,10,210,heavy,4
2015-10-14 17:30:00,147,20,49,7,223,normal,2
2015-10-14 17:45:00,140,22,27,5,194,heavy,4
2015-10-14 18:00:00,128,37,20,9,194,heavy,4
2015-10-14 18:15:00,114,23,42,10,189,heavy,4
2015-10-14 18:30:00,117,20,22,9,168,heavy,4
2015-10-14 18:45:00,93,24,17,23,157,high,3
2015-10-14 19:00:00,65,15,15,8,103,low,1
2015-10-14 19:15:00,100,22,14,8,144,normal,2
2015-10-14 19:30:00,85,12,11,18,126,normal,2
2015-10-14 19:45:00,56,7,12,12,87,low,1
2015-10-14 20:00:00,50,12,15,18,95,normal,2
2015-10-14 20:15:00,74,9,11,12,106,low,1
2015-10-14 20:30:00,73,15,18,7,113,normal,2
2015-10-14 20:45:00,99,13,20,30,162,high,3
2015-10-14 21:00:00,110,14,17,8,149,normal,2
2015-10-14 21:15:00,82,5,12,34,133,high,3
2015-10-14 21:30:00,58,19,12,17,106,normal,2
2015-10-14 21:45:00,70,10,14,32,126,high,3
2015-10-14 22:00:00,10,1,0,33,44,normal,2
2015-10-14 22:15:00,14,1,1,40,56,normal,2
2015-10-14 22:30:00,17,1,1,17,36,normal,2
2015-10-14 22:45:00,12,4,1,22,39,normal,2
2015-10-14 23:00:00,15,0,0,16,31,normal,2
2015-10-14 23:15:00,13,4,0,25,42,normal,2
2015-10-14 23:30:00,14,5,1,12,32,low,1
2015-10-14 23:45:00,18,1,1,35,55,normal,2
2015-10-15 00:00:00,18,5,1,19,43,normal,2
2015-10-15 00:15:00,19,3,0,38,60,normal,2
2015-10-15 00:30:00,13,0,1,12,26,low,1
2015-10-15 00:45:00,20,0,1,38,59,normal,2
2015-10-15 01:00:00,20,1,1,24,46,normal,2
2015-10-15 01:15:00,17,3,1,17,38,normal,2
2015-10-15 01:30:00,12,3,1,35,51,normal,2
2015-10-15 01:45:00,19,0,1,30,50,normal,2
2015-10-15 02:00:00,19,2,1,30,52,normal,2
2015-10-15 02:15:00,18,1,0,16,35,normal,2
2015-10-15 02:30:00,11,0,0,31,42,normal,2
2015-10-15 02:45:00,10,1,1,12,24,low,1
2015-10-15 03:00:00,16,1,0,24,41,normal,2
2015-10-15 03:15:00,18,3,0,28,49,normal,2
2015-10-15 03:30:00,20,1,1,39,61,normal,2
2015-10-15 03:45:00,19,3,1,27,50,normal,2
2015-10-15 04:00:00,14,1,1,34,50,normal,2
2015-10-15 04:15:00,61,26,1,16,104,normal,2
2015-10-15 04:30:00,72,26,6,4,108,low,1
2015-10-15 04:45:00,86,24,3,18,131,normal,2
2015-10-15 05:00:00,75,1,8,10,94,low,1
2015-10-15 05:15:00,75,1,7,9,92,low,1
2015-10-15 05:30:00,93,5,4,1,103,low,1
2015-10-15 05:45:00,111,6,2,5,124,normal,2
2015-10-15 06:00:00,111,18,41,2,172,heavy,4
2015-10-15 06:15:00,114,27,46,0,187,heavy,4
2015-10-15 06:30:00,139,19,50,2,210,heavy,4
2015-10-15 06:45:00,109,14,38,1,162,high,3
2015-10-15 07:00:00,105,16,22,3,146,normal,2
2015-10-15 07:15:00,150,13,31,4,198,heavy,4
2015-10-15 07:30:00,122,13,47,3,185,heavy,4
2015-10-15 07:45:00,114,24,46,2,186,heavy,4
2015-10-15 08:00:00,119,36,41,0,196,heavy,4
2015-10-15 08:15:00,108,35,39,0,182,heavy,4
2015-10-15 08:30:00,113,18,28,1,160,high,3
2015-10-15 08:45:00,118,36,37,0,191,heavy,4
2015-10-15 09:00:00,113,35,48,3,199,heavy,4
2015-10-15 09:15:00,66,7,22,30,125,high,3
2015-10-15 09:30:00,64,12,27,8,111,normal,2
2015-10-15 09:45:00,37,5,13,11,66,low,1
2015-10-15 10:00:00,82,17,31,20,150,high,3
2015-10-15 10:15:00,63,5,23,12,103,normal,2
2015-10-15 10:30:00,20,12,16,24,72,normal,2
2015-10-15 10:45:00,46,5,34,9,94,normal,2
2015-10-15 11:00:00,35,9,8,29,81,normal,2
2015-10-15 11:15:00,33,9,11,21,74,normal,2
2015-10-15 11:30:00,32,9,10,30,81,normal,2
2015-10-15 11:45:00,62,10,6,22,100,normal,2
2015-10-15 12:00:00,62,10,11,22,105,normal,2
2015-10-15 12:15:00,54,10,12,25,101,normal,2
2015-10-15 12:30:00,48,8,15,23,94,normal,2
2015-10-15 12:45:00,20,10,12,24,66,normal,2
2015-10-15 13:00:00,35,10,5,30,80,normal,2
2015-10-15 13:15:00,112,15,40,10,177,heavy,4
2015-10-15 13:30:00,51,21,25,13,110,normal,2
2015-10-15 13:45:00,53,12,23,8,96,normal,2
2015-10-15 14:00:00,63,22,18,15,118,normal,2
2015-10-15 14:15:00,50,23,16,8,97,normal,2
2015-10-15 14:30:00,94,20,35,17,166,high,3
2015-10-15 14:45:00,7,27,39,17,90,normal,2
2015-10-15 15:00:00,109,18,13,6,146,normal,2
2015-10-15 15:15:00,18,27,19,6,70,normal,2
2015-10-15 15:30:00,21,30,5,5,61,low,1
2015-10-15 15:45:00,49,16,9,12,86,low,1
2015-10-15 16:00:00,129,28,40,6,203,heavy,4
2015-10-15 16:15:00,141,18,28,8,195,heavy,4
2015-10-15 16:30:00,131,14,43,7,195,heavy,4
2015-10-15 16:45:00,105,38,23,5,171,heavy,4
2015-10-15 17:00:00,125,35,37,5,202,heavy,4
2015-10-15 17:15:00,127,36,42,9,214,heavy,4
2015-10-15 17:30:00,129,22,25,9,185,heavy,4
2015-10-15 17:45:00,121,39,47,8,215,heavy,4
2015-10-15 18:00:00,138,29,42,9,218,heavy,4
2015-10-15 18:15:00,119,26,21,5,171,heavy,4
2015-10-15 18:30:00,138,17,48,8,211,heavy,4
2015-10-15 18:45:00,72,12,14,32,130,high,3
2015-10-15 19:00:00,92,23,20,30,165,high,3
2015-10-15 19:15:00,94,17,11,24,146,high,3
2015-10-15 19:30:00,102,25,12,24,163,high,3
2015-10-15 19:45:00,71,23,17,14,125,normal,2
2015-10-15 20:00:00,58,5,19,25,107,normal,2
2015-10-15 20:15:00,93,22,18,10,143,normal,2
2015-10-15 20:30:00,59,23,10,35,127,high,3
2015-10-15 20:45:00,57,20,10,20,107,normal,2
2015-10-15 21:00:00,96,9,18,25,148,high,3
2015-10-15 21:15:00,104,12,16,20,152,normal,2
2015-10-15 21:30:00,104,22,17,23,166,high,3
2015-10-15 21:45:00,88,8,11,29,136,high,3
2015-10-15 22:00:00,20,3,0,16,39,normal,2
2015-10-15 22:15:00,17,2,1,30,50,normal,2
2015-10-15 22:30:00,17,4,0,23,44,normal,2
2015-10-15 22:45:00,15,5,0,21,41,normal,2
2015-10-15 23:00:00,10,0,1,31,42,normal,2
2015-10-15 23:15:00,11,1,1,19,32,normal,2
2015-10-15 23:30:00,12,2,0,29,43,normal,2
2015-10-15 23:45:00,11,0,1,11,23,low,1
2015-10-16 00:00:00,18,4,1,28,51,normal,2
2015-10-16 00:15:00,13,3,0,26,42,normal,2
2015-10-16 00:30:00,16,3,0,34,53,normal,2
2015-10-16 00:45:00,16,4,0,35,55,normal,2
2015-10-16 01:00:00,20,2,1,33,56,normal,2
2015-10-16 01:15:00,14,4,1,28,47,normal,2
2015-10-16 01:30:00,11,4,1,19,35,normal,2
2015-10-16 01:45:00,19,4,0,17,40,normal,2
2015-10-16 02:00:00,18,3,1,26,48,normal,2
2015-10-16 02:15:00,10,1,1,21,33,normal,2
2015-10-16 02:30:00,20,5,1,40,66,normal,2
2015-10-16 02:45:00,11,5,0,37,53,normal,2
2015-10-16 03:00:00,15,4,1,29,49,normal,2
2015-10-16 03:15:00,16,2,1,27,46,normal,2
2015-10-16 03:30:00,10,3,1,23,37,normal,2
2015-10-16 03:45:00,16,5,1,31,53,normal,2
2015-10-16 04:00:00,20,0,1,30,51,normal,2
2015-10-16 04:15:00,61,4,5,17,87,normal,2
2015-10-16 04:30:00,91,8,6,2,107,low,1
2015-10-16 04:45:00,94,4,5,2,105,low,1
2015-10-16 05:00:00,117,8,6,16,147,normal,2
2015-10-16 05:15:00,111,14,10,14,149,normal,2
2015-10-16 05:30:00,91,2,3,5,101,low,1
2015-10-16 05:45:00,96,9,1,16,122,normal,2
2015-10-16 06:00:00,134,15,42,5,196,heavy,4
2015-10-16 06:15:00,121,35,39,4,199,heavy,4
2015-10-16 06:30:00,118,40,40,3,201,heavy,4
2015-10-16 06:45:00,115,17,40,1,173,heavy,4
2015-10-16 07:00:00,106,22,37,0,165,high,3
2015-10-16 07:15:00,147,26,40,0,213,heavy,4
2015-10-16 07:30:00,102,13,31,2,148,high,3
2015-10-16 07:45:00,102,12,24,3,141,normal,2
2015-10-16 08:00:00,130,40,31,2,203,heavy,4
2015-10-16 08:15:00,102,17,33,0,152,high,3
2015-10-16 08:30:00,105,13,48,5,171,heavy,4
2015-10-16 08:45:00,129,24,25,0,178,heavy,4
2015-10-16 09:00:00,117,11,45,0,173,heavy,4
2015-10-16 09:15:00,74,14,23,21,132,high,3
2015-10-16 09:30:00,80,14,35,18,147,high,3
2015-10-16 09:45:00,31,7,34,24,96,normal,2
2015-10-16 10:00:00,18,15,9,15,57,normal,2
2015-10-16 10:15:00,15,10,23,20,68,normal,2
2015-10-16 10:30:00,37,18,8,16,79,normal,2
2015-10-16 10:45:00,10,7,5,14,36,normal,2
2015-10-16 11:00:00,54,6,15,23,98,normal,2
2015-10-16 11:15:00,34,7,5,24,70,normal,2
2015-10-16 11:30:00,50,7,8,21,86,normal,2
2015-10-16 11:45:00,44,9,10,24,87,normal,2
2015-10-16 12:00:00,63,8,15,24,110,normal,2
2015-10-16 12:15:00,56,6,6,29,97,normal,2
2015-10-16 12:30:00,69,5,13,27,114,high,3
2015-10-16 12:45:00,39,5,3,30,77,normal,2
2015-10-16 13:00:00,61,10,14,24,109,normal,2
2015-10-16 13:15:00,61,30,5,20,116,normal,2
2015-10-16 13:30:00,20,17,9,5,51,low,1
2015-10-16 13:45:00,70,22,38,7,137,high,3
2015-10-16 14:00:00,25,30,31,9,95,normal,2
2015-10-16 14:15:00,23,13,12,6,54,low,1
2015-10-16 14:30:00,105,30,24,8,167,normal,2
2015-10-16 14:45:00,107,10,6,6,129,normal,2
2015-10-16 15:00:00,40,20,36,7,103,normal,2
2015-10-16 15:15:00,74,18,37,11,140,high,3
2015-10-16 15:30:00,62,15,8,11,96,low,1
2015-10-16 15:45:00,81,20,14,12,127,normal,2
2015-10-16 16:00:00,111,32,43,5,191,heavy,4
2015-10-16 16:15:00,145,12,41,6,204,heavy,4
2015-10-16 16:30:00,139,11,20,7,177,heavy,4
2015-10-16 16:45:00,129,40,31,10,210,heavy,4
2015-10-16 17:00:00,128,22,28,8,186,heavy,4
2015-10-16 17:15:00,103,17,23,8,151,normal,2
2015-10-16 17:30:00,127,32,29,7,195,heavy,4
2015-10-16 17:45:00,120,35,44,8,207,heavy,4
2015-10-16 18:00:00,106,11,41,7,165,high,3
2015-10-16 18:15:00,114,40,31,5,190,heavy,4
2015-10-16 18:30:00,101,13,20,7,141,normal,2
2015-10-16 18:45:00,110,25,19,34,188,heavy,4
2015-10-16 19:00:00,108,6,17,23,154,high,3
2015-10-16 19:15:00,104,12,10,10,136,normal,2
2015-10-16 19:30:00,102,22,17,23,164,high,3
2015-10-16 19:45:00,77,19,16,8,120,normal,2
2015-10-16 20:00:00,70,16,19,33,138,high,3
2015-10-16 20:15:00,75,9,13,28,125,high,3
2015-10-16 20:30:00,95,9,16,29,149,high,3
2015-10-16 20:45:00,77,17,17,22,133,high,3
2015-10-16 21:00:00,73,16,14,34,137,high,3
2015-10-16 21:15:00,59,7,18,12,96,normal,2
2015-10-16 21:30:00,54,20,10,9,93,low,1
2015-10-16 21:45:00,90,6,18,32,146,high,3
2015-10-16 22:00:00,15,5,1,32,53,normal,2
2015-10-16 22:15:00,12,1,0,11,24,low,1
2015-10-16 22:30:00,17,2,0,28,47,normal,2
2015-10-16 22:45:00,13,5,1,12,31,low,1
2015-10-16 23:00:00,15,5,0,21,41,normal,2
2015-10-16 23:15:00,18,4,0,11,33,low,1
2015-10-16 23:30:00,12,4,0,21,37,normal,2
2015-10-16 23:45:00,10,4,1,12,27,low,1
2015-10-17 00:00:00,15,2,0,25,42,normal,2
2015-10-17 00:15:00,11,0,0,24,35,normal,2
2015-10-17 00:30:00,15,2,1,15,33,normal,2
2015-10-17 00:45:00,20,3,1,29,53,normal,2
2015-10-17 01:00:00,17,2,0,24,43,normal,2
2015-10-17 01:15:00,19,5,1,26,51,normal,2
2015-10-17 01:30:00,20,3,1,32,56,normal,2
2015-10-17 01:45:00,15,3,0,19,37,normal,2
2015-10-17 02:00:00,13,5,0,17,35,normal,2
2015-10-17 02:15:00,12,5,1,19,37,normal,2
2015-10-17 02:30:00,10,2,0,27,39,normal,2
2015-10-17 02:45:00,20,4,1,23,48,normal,2
2015-10-17 03:00:00,14,0,0,16,30,normal,2
2015-10-17 03:15:00,12,4,1,28,45,normal,2
2015-10-17 03:30:00,19,2,0,20,41,normal,2
2015-10-17 03:45:00,20,2,1,19,42,normal,2
2015-10-17 04:00:00,16,0,0,36,52,normal,2
2015-10-17 04:15:00,62,20,4,18,104,normal,2
2015-10-17 04:30:00,50,13,2,14,79,normal,2
2015-10-17 04:45:00,101,3,6,6,116,normal,2
2015-10-17 05:00:00,94,15,2,9,120,normal,2
2015-10-17 05:15:00,68,10,8,1,87,low,1
2015-10-17 05:30:00,95,3,8,20,126,normal,2
2015-10-17 05:45:00,113,7,10,16,146,normal,2
2015-10-17 06:00:00,106,13,39,1,159,high,3
2015-10-17 06:15:00,105,32,47,4,188,heavy,4
2015-10-17 06:30:00,150,19,34,4,207,heavy,4
2015-10-17 06:45:00,137,38,39,2,216,heavy,4
2015-10-17 07:00:00,113,11,32,1,157,high,3
2015-10-17 07:15:00,117,30,26,5,178,heavy,4
2015-10-17 07:30:00,130,10,37,1,178,heavy,4
2015-10-17 07:45:00,150,32,31,1,214,heavy,4
2015-10-17 08:00:00,146,10,30,3,189,heavy,4
2015-10-17 08:15:00,123,24,46,2,195,heavy,4
2015-10-17 08:30:00,110,24,26,4,164,high,3
2015-10-17 08:45:00,111,33,31,2,177,heavy,4
2015-10-17 09:00:00,132,18,32,2,184,heavy,4
2015-10-17 09:15:00,66,16,22,13,117,normal,2
2015-10-17 09:30:00,45,24,5,23,97,normal,2
2015-10-17 09:45:00,92,19,15,7,133,normal,2
2015-10-17 10:00:00,78,22,16,25,141,high,3
2015-10-17 10:15:00,90,2,15,18,125,normal,2
2015-10-17 10:30:00,23,2,37,9,71,normal,2
2015-10-17 10:45:00,17,5,6,20,48,normal,2
2015-10-17 11:00:00,41,5,4,24,74,normal,2
2015-10-17 11:15:00,32,5,15,26,78,normal,2
2015-10-17 11:30:00,65,7,7,22,101,normal,2
2015-10-17 11:45:00,22,6,3,25,56,normal,2
2015-10-17 12:00:00,54,7,4,28,93,normal,2
2015-10-17 12:15:00,38,5,8,28,79,normal,2
2015-10-17 12:30:00,59,7,15,23,104,normal,2
2015-10-17 12:45:00,34,8,10,23,75,normal,2
2015-10-17 13:00:00,28,6,3,27,64,normal,2
2015-10-17 13:15:00,7,16,11,14,48,normal,2
2015-10-17 13:30:00,8,12,22,8,50,normal,2
2015-10-17 13:45:00,42,25,38,18,123,high,3
2015-10-17 14:00:00,82,13,28,5,128,high,3
2015-10-17 14:15:00,14,24,26,9,73,normal,2
2015-10-17 14:30:00,39,25,33,9,106,normal,2
2015-10-17 14:45:00,47,14,29,6,96,normal,2
2015-10-17 15:00:00,120,20,21,18,179,heavy,4
2015-10-17 15:15:00,114,11,39,10,174,heavy,4
2015-10-17 15:30:00,99,24,30,10,163,high,3
2015-10-17 15:45:00,78,18,30,8,134,high,3
2015-10-17 16:00:00,144,40,29,10,223,normal,2
2015-10-17 16:15:00,107,28,38,9,182,heavy,4
2015-10-17 16:30:00,123,28,24,10,185,heavy,4
2015-10-17 16:45:00,126,15,28,6,175,heavy,4
2015-10-17 17:00:00,147,28,23,5,203,heavy,4
2015-10-17 17:15:00,100,21,33,7,161,high,3
2015-10-17 17:30:00,113,12,22,6,153,normal,2
2015-10-17 17:45:00,130,34,30,6,200,heavy,4
2015-10-17 18:00:00,118,40,29,10,197,heavy,4
2015-10-17 18:15:00,113,38,44,9,204,heavy,4
2015-10-17 18:30:00,117,29,29,9,184,heavy,4
2015-10-17 18:45:00,106,12,20,32,170,heavy,4
2015-10-17 19:00:00,96,11,15,14,136,normal,2
2015-10-17 19:15:00,58,11,14,24,107,normal,2
2015-10-17 19:30:00,76,22,10,9,117,normal,2
2015-10-17 19:45:00,66,6,12,33,117,high,3
2015-10-17 20:00:00,61,23,13,18,115,normal,2
2015-10-17 20:15:00,93,6,15,17,131,normal,2
2015-10-17 20:30:00,51,11,16,26,104,normal,2
2015-10-17 20:45:00,86,6,12,9,113,normal,2
2015-10-17 21:00:00,77,15,12,29,133,high,3
2015-10-17 21:15:00,84,15,16,8,123,normal,2
2015-10-17 21:30:00,103,12,15,10,140,normal,2
2015-10-17 21:45:00,60,9,11,27,107,normal,2
2015-10-17 22:00:00,14,1,1,22,38,normal,2
2015-10-17 22:15:00,14,2,0,35,51,normal,2
2015-10-17 22:30:00,13,1,1,31,46,normal,2
2015-10-17 22:45:00,19,0,1,22,42,normal,2
2015-10-17 23:00:00,13,4,0,28,45,normal,2
2015-10-17 23:15:00,13,1,0,26,40,normal,2
2015-10-17 23:30:00,12,0,1,34,47,normal,2
2015-10-17 23:45:00,20,1,1,38,60,normal,2
2015-10-18 00:00:00,12,3,0,38,53,normal,2
2015-10-18 00:15:00,12,1,0,40,53,normal,2
2015-10-18 00:30:00,20,5,0,10,35,low,1
2015-10-18 00:45:00,12,4,1,27,44,normal,2
2015-10-18 01:00:00,15,5,0,21,41,normal,2
2015-10-18 01:15:00,19,2,0,30,51,normal,2
2015-10-18 01:30:00,11,0,1,40,52,normal,2
2015-10-18 01:45:00,15,3,0,35,53,normal,2
2015-10-18 02:00:00,15,0,1,37,53,normal,2
2015-10-18 02:15:00,16,2,0,37,55,normal,2
2015-10-18 02:30:00,10,0,1,24,35,normal,2
2015-10-18 02:45:00,12,0,1,31,44,normal,2
2015-10-18 03:00:00,15,1,1,36,53,normal,2
2015-10-18 03:15:00,14,5,0,17,36,normal,2
2015-10-18 03:30:00,17,3,1,38,59,normal,2
2015-10-18 03:45:00,19,0,0,18,37,normal,2
2015-10-18 04:00:00,18,5,1,30,54,normal,2
2015-10-18 04:15:00,119,12,6,4,141,normal,2
2015-10-18 04:30:00,74,28,1,13,116,normal,2
2015-10-18 04:45:00,101,26,10,0,137,normal,2
2015-10-18 05:00:00,99,4,7,19,129,normal,2
2015-10-18 05:15:00,99,18,7,5,129,normal,2
2015-10-18 05:30:00,102,24,2,8,136,normal,2
2015-10-18 05:45:00,50,4,6,13,73,normal,2
2015-10-18 06:00:00,128,11,46,4,189,heavy,4
2015-10-18 06:15:00,129,39,43,0,211,heavy,4
2015-10-18 06:30:00,129,27,38,0,194,heavy,4
2015-10-18 06:45:00,113,24,22,2,161,normal,2
2015-10-18 07:00:00,141,15,21,5,182,heavy,4
2015-10-18 07:15:00,120,22,29,1,172,heavy,4
2015-10-18 07:30:00,141,24,47,4,216,heavy,4
2015-10-18 07:45:00,149,24,33,1,207,heavy,4
2015-10-18 08:00:00,140,40,36,1,217,heavy,4
2015-10-18 08:15:00,140,20,36,0,196,heavy,4
2015-10-18 08:30:00,107,13,31,4,155,high,3
2015-10-18 08:45:00,141,15,32,4,192,heavy,4
2015-10-18 09:00:00,120,27,38,4,189,heavy,4
2015-10-18 09:15:00,70,14,21,5,110,normal,2
2015-10-18 09:30:00,55,24,16,21,116,high,3
2015-10-18 09:45:00,52,18,22,16,108,normal,2
2015-10-18 10:00:00,65,4,19,21,109,normal,2
2015-10-18 10:15:00,54,10,30,28,122,high,3
2015-10-18 10:30:00,37,3,32,18,90,normal,2
2015-10-18 10:45:00,23,3,37,18,81,normal,2
2015-10-18 11:00:00,43,7,7,29,86,normal,2
2015-10-18 11:15:00,22,6,13,24,65,normal,2
2015-10-18 11:30:00,21,10,6,30,67,normal,2
2015-10-18 11:45:00,48,8,11,22,89,normal,2
2015-10-18 12:00:00,35,5,12,20,72,normal,2
2015-10-18 12:15:00,69,5,13,22,109,normal,2
2015-10-18 12:30:00,22,9,10,21,62,normal,2
2015-10-18 12:45:00,46,5,9,23,83,normal,2
2015-10-18 13:00:00,49,5,11,21,86,normal,2
2015-10-18 13:15:00,29,18,29,20,96,normal,2
2015-10-18 13:30:00,96,23,31,14,164,high,3
2015-10-18 13:45:00,100,27,23,16,166,normal,2
2015-10-18 14:00:00,96,22,36,5,159,high,3
2015-10-18 14:15:00,27,26,25,15,93,normal,2
2015-10-18 14:30:00,114,21,32,5,172,heavy,4
2015-10-18 14:45:00,74,27,34,10,145,high,3
2015-10-18 15:00:00,14,16,9,14,53,normal,2
2015-10-18 15:15:00,84,30,26,10,150,high,3
2015-10-18 15:30:00,96,19,14,18,147,normal,2
2015-10-18 15:45:00,40,15,28,5,88,normal,2
2015-10-18 16:00:00,110,15,46,5,176,heavy,4
2015-10-18 16:15:00,138,39,31,7,215,heavy,4
2015-10-18 16:30:00,118,32,32,10,192,heavy,4
2015-10-18 16:45:00,142,34,38,9,223,normal,2
2015-10-18 17:00:00,113,13,36,5,167,normal,2
2015-10-18 17:15:00,104,29,32,7,172,heavy,4
2015-10-18 17:30:00,134,39,21,9,203,heavy,4
2015-10-18 17:45:00,107,15,48,5,175,heavy,4
2015-10-18 18:00:00,139,25,43,7,214,heavy,4
2015-10-18 18:15:00,128,20,20,6,174,heavy,4
2015-10-18 18:30:00,101,13,47,10,171,heavy,4
2015-10-18 18:45:00,105,17,13,23,158,high,3
2015-10-18 19:00:00,103,14,13,9,139,normal,2
2015-10-18 19:15:00,51,23,15,13,102,normal,2
2015-10-18 19:30:00,84,10,16,20,130,normal,2
2015-10-18 19:45:00,97,25,19,24,165,high,3
2015-10-18 20:00:00,98,8,10,19,135,normal,2
2015-10-18 20:15:00,94,13,19,25,151,high,3
2015-10-18 20:30:00,105,25,11,35,176,heavy,4
2015-10-18 20:45:00,74,9,13,6,102,low,1
2015-10-18 21:00:00,57,18,13,28,116,high,3
2015-10-18 21:15:00,57,14,11,33,115,high,3
2015-10-18 21:30:00,84,23,19,15,141,normal,2
2015-10-18 21:45:00,105,14,16,33,168,heavy,4
2015-10-18 22:00:00,10,4,1,38,53,normal,2
2015-10-18 22:15:00,15,1,1,29,46,normal,2
2015-10-18 22:30:00,14,1,1,25,41,normal,2
2015-10-18 22:45:00,20,2,0,37,59,normal,2
2015-10-18 23:00:00,20,1,0,27,48,normal,2
2015-10-18 23:15:00,13,1,1,18,33,normal,2
2015-10-18 23:30:00,19,0,0,35,54,normal,2
2015-10-18 23:45:00,14,1,1,27,43,normal,2
2015-10-19 00:00:00,13,5,0,12,30,low,1
2015-10-19 00:15:00,18,5,0,12,35,low,1
2015-10-19 00:30:00,10,3,1,32,46,normal,2
2015-10-19 00:45:00,14,2,0,15,31,normal,2
2015-10-19 01:00:00,16,3,0,15,34,normal,2
2015-10-19 01:15:00,14,2,0,25,41,normal,2
2015-10-19 01:30:00,17,5,0,18,40,normal,2
2015-10-19 01:45:00,13,1,0,28,42,normal,2
2015-10-19 02:00:00,19,0,1,20,40,normal,2
2015-10-19 02:15:00,15,4,0,40,59,normal,2
2015-10-19 02:30:00,14,3,1,26,44,normal,2
2015-10-19 02:45:00,15,4,0,14,33,normal,2
2015-10-19 03:00:00,12,3,1,13,29,normal,2
2015-10-19 03:15:00,12,4,0,31,47,normal,2
2015-10-19 03:30:00,17,4,1,20,42,normal,2
2015-10-19 03:45:00,12,0,1,13,26,normal,2
2015-10-19 04:00:00,18,2,0,16,36,normal,2
2015-10-19 04:15:00,115,16,10,13,154,normal,2
2015-10-19 04:30:00,117,5,10,15,147,normal,2
2015-10-19 04:45:00,92,26,8,7,133,normal,2
2015-10-19 05:00:00,88,3,6,4,101,low,1
2015-10-19 05:15:00,109,11,4,3,127,normal,2
2015-10-19 05:30:00,81,4,0,20,105,normal,2
2015-10-19 05:45:00,118,2,5,19,144,normal,2
2015-10-19 06:00:00,107,26,31,2,166,high,3
2015-10-19 06:15:00,103,11,35,5,154,high,3
2015-10-19 06:30:00,145,13,33,3,194,heavy,4
2015-10-19 06:45:00,143,22,37,4,206,heavy,4
2015-10-19 07:00:00,113,38,50,3,204,heavy,4
2015-10-19 07:15:00,149,10,47,3,209,heavy,4
2015-10-19 07:30:00,132,33,35,2,202,heavy,4
2015-10-19 07:45:00,119,40,41,2,202,heavy,4
2015-10-19 08:00:00,133,31,27,2,193,heavy,4
2015-10-19 08:15:00,140,20,44,4,208,heavy,4
2015-10-19 08:30:00,140,34,31,1,206,heavy,4
2015-10-19 08:45:00,128,37,50,2,217,heavy,4
2015-10-19 09:00:00,132,11,24,3,170,heavy,4
2015-10-19 09:15:00,23,8,40,27,98,normal,2
2015-10-19 09:30:00,75,2,18,29,124,high,3
2015-10-19 09:45:00,99,14,33,14,160,high,3
2015-10-19 10:00:00,10,1,13,7,31,low,1
2015-10-19 10:15:00,74,21,29,26,150,high,3
2015-10-19 10:30:00,29,15,25,5,74,normal,2
2015-10-19 10:45:00,50,17,38,24,129,high,3
2015-10-19 11:00:00,64,9,14,20,107,normal,2
2015-10-19 11:15:00,49,5,10,21,85,normal,2
2015-10-19 11:30:00,39,7,10,30,86,normal,2
2015-10-19 11:45:00,68,5,5,24,102,normal,2
2015-10-19 12:00:00,67,7,8,22,104,normal,2
2015-10-19 12:15:00,47,8,3,25,83,normal,2
2015-10-19 12:30:00,66,9,7,24,106,normal,2
2015-10-19 12:45:00,46,8,3,22,79,normal,2
2015-10-19 13:00:00,54,6,12,21,93,normal,2
2015-10-19 13:15:00,18,16,32,18,84,normal,2
2015-10-19 13:30:00,24,20,7,9,60,low,1
2015-10-19 13:45:00,113,17,16,20,166,normal,2
2015-10-19 14:00:00,52,13,15,10,90,low,1
2015-10-19 14:15:00,58,26,25,18,127,normal,2
2015-10-19 14:30:00,44,19,22,6,91,normal,2
2015-10-19 14:45:00,8,26,34,9,77,normal,2
2015-10-19 15:00:00,31,10,27,8,76,normal,2
2015-10-19 15:15:00,115,24,16,5,160,normal,2
2015-10-19 15:30:00,56,29,16,16,117,normal,2
2015-10-19 15:45:00,7,12,33,12,64,normal,2
2015-10-19 16:00:00,133,10,46,10,199,heavy,4
2015-10-19 16:15:00,104,31,37,6,178,heavy,4
2015-10-19 16:30:00,100,38,36,9,183,heavy,4
2015-10-19 16:45:00,127,25,37,5,194,heavy,4
2015-10-19 17:00:00,118,32,48,6,204,heavy,4
2015-10-19 17:15:00,147,19,31,8,205,heavy,4
2015-10-19 17:30:00,123,36,34,5,198,heavy,4
2015-10-19 17:45:00,111,24,25,5,165,normal,2
2015-10-19 18:00:00,121,16,42,8,187,heavy,4
2015-10-19 18:15:00,119,38,47,7,211,heavy,4
2015-10-19 18:30:00,132,30,41,6,209,heavy,4
2015-10-19 18:45:00,52,6,12,18,88,normal,2
2015-10-19 19:00:00,97,21,10,8,136,normal,2
2015-10-19 19:15:00,50,16,20,31,117,high,3
2015-10-19 19:30:00,94,25,19,8,146,normal,2
2015-10-19 19:45:00,66,11,18,34,129,high,3
2015-10-19 20:00:00,105,16,15,6,142,normal,2
2015-10-19 20:15:00,56,23,10,18,107,normal,2
2015-10-19 20:30:00,105,19,10,25,159,high,3
2015-10-19 20:45:00,60,18,11,16,105,normal,2
2015-10-19 21:00:00,88,10,14,11,123,normal,2
2015-10-19 21:15:00,110,6,14,23,153,high,3
2015-10-19 21:30:00,78,20,11,35,144,high,3
2015-10-19 21:45:00,105,14,10,7,136,normal,2
2015-10-19 22:00:00,18,1,0,10,29,low,1
2015-10-19 22:15:00,18,1,0,27,46,normal,2
2015-10-19 22:30:00,12,4,1,18,35,normal,2
2015-10-19 22:45:00,15,4,1,32,52,normal,2
2015-10-19 23:00:00,13,4,0,32,49,normal,2
2015-10-19 23:15:00,14,4,0,15,33,normal,2
2015-10-19 23:30:00,15,4,0,17,36,normal,2
2015-10-19 23:45:00,14,0,1,21,36,normal,2
2015-10-20 00:00:00,17,5,0,37,59,normal,2
2015-10-20 00:15:00,14,4,1,12,31,low,1
2015-10-20 00:30:00,16,2,0,15,33,normal,2
2015-10-20 00:45:00,13,4,1,14,32,normal,2
2015-10-20 01:00:00,12,4,0,29,45,normal,2
2015-10-20 01:15:00,19,4,1,30,54,normal,2
2015-10-20 01:30:00,18,4,0,18,40,normal,2
2015-10-20 01:45:00,18,1,1,12,32,low,1
2015-10-20 02:00:00,20,4,1,21,46,normal,2
2015-10-20 02:15:00,10,2,1,20,33,normal,2
2015-10-20 02:30:00,18,5,1,23,47,normal,2
2015-10-20 02:45:00,16,5,1,30,52,normal,2
2015-10-20 03:00:00,12,3,0,40,55,normal,2
2015-10-20 03:15:00,12,2,0,40,54,normal,2
2015-10-20 03:30:00,16,0,1,37,54,normal,2
2015-10-20 03:45:00,15,4,1,16,36,normal,2
2015-10-20 04:00:00,13,0,0,38,51,normal,2
2015-10-20 04:15:00,61,5,3,14,83,normal,2
2015-10-20 04:30:00,27,15,6,10,58,low,1
2015-10-20 04:45:00,74,11,5,15,105,normal,2
2015-10-20 05:00:00,70,6,7,14,97,normal,2
2015-10-20 05:15:00,33,6,0,11,50,low,1
2015-10-20 05:30:00,29,12,1,13,55,normal,2
2015-10-20 05:45:00,69,5,7,10,91,low,1
2015-10-20 06:00:00,41,16,7,15,79,normal,2
2015-10-20 06:15:00,35,11,5,11,62,low,1
2015-10-20 06:30:00,25,9,6,14,54,normal,2
2015-10-20 06:45:00,65,15,1,11,92,low,1
2015-10-20 07:00:00,66,6,3,14,89,normal,2
2015-10-20 07:15:00,27,6,5,15,53,normal,2
2015-10-20 07:30:00,75,6,1,10,92,low,1
2015-10-20 07:45:00,54,11,4,12,81,low,1
2015-10-20 08:00:00,54,18,3,12,87,low,1
2015-10-20 08:15:00,69,8,0,14,91,normal,2
2015-10-20 08:30:00,52,19,6,10,87,low,1
2015-10-20 08:45:00,66,8,0,12,86,low,1
2015-10-20 09:00:00,54,11,0,13,78,normal,2
2015-10-20 09:15:00,151,48,15,3,217,heavy,4
2015-10-20 09:30:00,170,62,18,2,252,heavy,4
2015-10-20 09:45:00,134,59,11,3,207,heavy,4
2015-10-20 10:00:00,166,63,22,1,252,heavy,4
2015-10-20 10:15:00,173,64,10,2,249,heavy,4
2015-10-20 10:30:00,176,45,22,2,245,heavy,4
2015-10-20 10:45:00,162,59,27,1,249,heavy,4
2015-10-20 11:00:00,171,46,15,3,235,heavy,4
2015-10-20 11:15:00,158,44,26,2,230,heavy,4
2015-10-20 11:30:00,151,64,16,0,231,heavy,4
2015-10-20 11:45:00,162,65,14,3,244,heavy,4
2015-10-20 12:00:00,179,44,23,1,247,heavy,4
2015-10-20 12:15:00,175,59,11,3,248,heavy,4
2015-10-20 12:30:00,173,63,13,2,251,heavy,4
2015-10-20 12:45:00,144,66,11,3,224,heavy,4
2015-10-20 13:00:00,132,68,22,4,226,heavy,4
2015-10-20 13:15:00,161,50,10,0,221,heavy,4
2015-10-20 13:30:00,151,56,29,1,237,heavy,4
2015-10-20 13:45:00,168,59,24,1,252,heavy,4
2015-10-20 14:00:00,144,65,20,3,232,heavy,4
2015-10-20 14:15:00,179,63,12,2,256,heavy,4
2015-10-20 14:30:00,161,56,12,4,233,heavy,4
2015-10-20 14:45:00,134,67,12,1,214,heavy,4
2015-10-20 15:00:00,140,70,23,4,237,heavy,4
2015-10-20 15:15:00,66,29,24,1,120,normal,2
2015-10-20 15:30:00,60,27,17,2,106,normal,2
2015-10-20 15:45:00,89,27,10,2,128,normal,2
2015-10-20 16:00:00,81,29,5,0,115,normal,2
2015-10-20 16:15:00,78,22,12,1,113,normal,2
2015-10-20 16:30:00,71,24,18,2,115,normal,2
2015-10-20 16:45:00,50,26,9,1,86,low,1
2015-10-20 17:00:00,55,28,5,0,88,low,1
2015-10-20 17:15:00,61,20,25,1,107,normal,2
2015-10-20 17:30:00,76,22,14,2,114,normal,2
2015-10-20 17:45:00,50,20,23,1,94,normal,2
2015-10-20 18:00:00,89,26,0,2,117,normal,2
2015-10-20 18:15:00,62,20,17,0,99,normal,2
2015-10-20 18:30:00,83,20,23,2,128,normal,2
2015-10-20 18:45:00,65,20,2,0,87,low,1
2015-10-20 19:00:00,60,21,2,1,84,low,1
2015-10-20 19:15:00,36,8,3,9,56,low,1
2015-10-20 19:30:00,39,5,4,11,59,low,1
2015-10-20 19:45:00,26,8,3,0,37,low,1
2015-10-20 20:00:00,23,4,0,5,32,low,1
2015-10-20 20:15:00,50,2,0,4,56,low,1
2015-10-20 20:30:00,30,2,3,1,36,low,1
2015-10-20 20:45:00,48,10,4,2,64,low,1
2015-10-20 21:00:00,39,6,6,1,52,low,1
2015-10-20 21:15:00,47,10,3,9,69,low,1
2015-10-20 21:30:00,26,3,5,3,37,low,1
2015-10-20 21:45:00,25,6,3,9,43,low,1
2015-10-20 22:00:00,19,1,0,11,31,low,1
2015-10-20 22:15:00,16,5,0,26,47,normal,2
2015-10-20 22:30:00,15,2,1,39,57,normal,2
2015-10-20 22:45:00,14,5,0,11,30,low,1
2015-10-20 23:00:00,12,2,0,20,34,normal,2
2015-10-20 23:15:00,11,2,0,35,48,normal,2
2015-10-20 23:30:00,18,5,1,11,35,low,1
2015-10-20 23:45:00,17,2,0,20,39,normal,2
2015-10-21 00:00:00,19,5,1,30,55,normal,2
2015-10-21 00:15:00,17,4,1,24,46,normal,2
2015-10-21 00:30:00,16,3,0,14,33,normal,2
2015-10-21 00:45:00,16,3,1,23,43,normal,2
2015-10-21 01:00:00,20,0,1,17,38,normal,2
2015-10-21 01:15:00,20,0,0,37,57,normal,2
2015-10-21 01:30:00,18,0,1,30,49,normal,2
2015-10-21 01:45:00,19,1,0,14,34,normal,2
2015-10-21 02:00:00,18,5,0,29,52,normal,2
2015-10-21 02:15:00,11,1,0,22,34,normal,2
2015-10-21 02:30:00,20,3,0,24,47,normal,2
2015-10-21 02:45:00,12,2,1,10,25,low,1
2015-10-21 03:00:00,19,5,1,31,56,normal,2
2015-10-21 03:15:00,10,0,0,32,42,normal,2
2015-10-21 03:30:00,14,1,1,12,28,low,1
2015-10-21 03:45:00,14,2,1,24,41,normal,2
2015-10-21 04:00:00,10,3,0,32,45,normal,2
2015-10-21 04:15:00,97,23,6,17,143,normal,2
2015-10-21 04:30:00,104,22,7,11,144,normal,2
2015-10-21 04:45:00,100,15,8,20,143,normal,2
2015-10-21 05:00:00,87,7,7,4,105,low,1
2015-10-21 05:15:00,77,27,8,10,122,normal,2
2015-10-21 05:30:00,51,7,4,5,67,low,1
2015-10-21 05:45:00,79,1,10,6,96,low,1
2015-10-21 06:00:00,100,40,29,5,174,heavy,4
2015-10-21 06:15:00,112,13,39,0,164,high,3
2015-10-21 06:30:00,120,16,34,2,172,heavy,4
2015-10-21 06:45:00,123,14,26,3,166,high,3
2015-10-21 07:00:00,142,27,27,4,200,heavy,4
2015-10-21 07:15:00,139,38,49,2,228,heavy,4
2015-10-21 07:30:00,134,24,21,2,181,heavy,4
2015-10-21 07:45:00,102,13,31,0,146,high,3
2015-10-21 08:00:00,102,16,43,4,165,high,3
2015-10-21 08:15:00,106,16,32,1,155,high,3
2015-10-21 08:30:00,117,19,42,3,181,heavy,4
2015-10-21 08:45:00,139,36,40,3,218,heavy,4
2015-10-21 09:00:00,121,13,25,2,161,normal,2
2015-10-21 09:15:00,65,19,16,11,111,normal,2
2015-10-21 09:30:00,12,25,39,28,104,normal,2
2015-10-21 09:45:00,98,21,10,5,134,normal,2
2015-10-21 10:00:00,58,9,25,13,105,normal,2
2015-10-21 10:15:00,81,10,39,29,159,high,3
2015-10-21 10:30:00,67,20,33,29,149,high,3
2015-10-21 10:45:00,68,22,25,16,131,normal,2
2015-10-21 11:00:00,47,10,6,22,85,normal,2
2015-10-21 11:15:00,45,7,10,27,89,normal,2
2015-10-21 11:30:00,54,5,11,24,94,normal,2
2015-10-21 11:45:00,61,7,15,28,111,normal,2
2015-10-21 12:00:00,56,5,4,29,94,normal,2
2015-10-21 12:15:00,23,5,4,27,59,normal,2
2015-10-21 12:30:00,31,6,8,23,68,normal,2
2015-10-21 12:45:00,27,7,14,28,76,normal,2
2015-10-21 13:00:00,30,7,3,30,70,normal,2
2015-10-21 13:15:00,114,21,5,14,154,normal,2
2015-10-21 13:30:00,46,24,35,16,121,high,3
2015-10-21 13:45:00,68,29,29,20,146,high,3
2015-10-21 14:00:00,45,16,15,5,81,low,1
2015-10-21 14:15:00,86,13,11,20,130,normal,2
2015-10-21 14:30:00,44,11,19,15,89,normal,2
2015-10-21 14:45:00,45,17,13,20,95,normal,2
2015-10-21 15:00:00,106,17,7,12,142,normal,2
2015-10-21 15:15:00,44,16,9,13,82,normal,2
2015-10-21 15:30:00,77,23,13,9,122,normal,2
2015-10-21 15:45:00,53,17,26,8,104,normal,2
2015-10-21 16:00:00,138,18,20,8,184,heavy,4
2015-10-21 16:15:00,142,24,39,9,214,heavy,4
2015-10-21 16:30:00,114,25,21,7,167,normal,2
2015-10-21 16:45:00,116,35,42,6,199,heavy,4
2015-10-21 17:00:00,149,22,37,8,216,heavy,4
2015-10-21 17:15:00,100,12,39,7,158,high,3
2015-10-21 17:30:00,101,23,45,5,174,heavy,4
2015-10-21 17:45:00,122,40,48,10,220,heavy,4
2015-10-21 18:00:00,112,34,39,9,194,heavy,4
2015-10-21 18:15:00,112,12,41,5,170,heavy,4
2015-10-21 18:30:00,116,22,23,7,168,heavy,4
2015-10-21 18:45:00,90,13,15,33,151,high,3
2015-10-21 19:00:00,85,14,14,13,126,normal,2
2015-10-21 19:15:00,59,25,13,27,124,high,3
2015-10-21 19:30:00,108,5,15,22,150,high,3
2015-10-21 19:45:00,75,8,16,25,124,high,3
2015-10-21 20:00:00,96,15,12,27,150,high,3
2015-10-21 20:15:00,61,17,10,8,96,low,1
2015-10-21 20:30:00,84,25,20,30,159,high,3
2015-10-21 20:45:00,55,9,12,19,95,normal,2
2015-10-21 21:00:00,65,16,12,32,125,high,3
2015-10-21 21:15:00,87,16,10,16,129,normal,2
2015-10-21 21:30:00,75,5,12,21,113,high,3
2015-10-21 21:45:00,82,16,14,34,146,high,3
2015-10-21 22:00:00,11,3,0,34,48,normal,2
2015-10-21 22:15:00,15,5,0,14,34,normal,2
2015-10-21 22:30:00,18,5,1,13,37,normal,2
2015-10-21 22:45:00,19,2,1,34,56,normal,2
2015-10-21 23:00:00,20,4,1,26,51,normal,2
2015-10-21 23:15:00,14,4,0,10,28,low,1
2015-10-21 23:30:00,11,1,1,36,49,normal,2
2015-10-21 23:45:00,10,2,1,15,28,normal,2
2015-10-22 00:00:00,10,3,0,33,46,normal,2
2015-10-22 00:15:00,14,3,0,23,40,normal,2
2015-10-22 00:30:00,11,5,1,11,28,low,1
2015-10-22 00:45:00,10,1,1,34,46,normal,2
2015-10-22 01:00:00,20,4,1,17,42,normal,2
2015-10-22 01:15:00,17,5,0,24,46,normal,2
2015-10-22 01:30:00,12,2,1,18,33,normal,2
2015-10-22 01:45:00,15,0,1,16,32,normal,2
2015-10-22 02:00:00,19,5,0,15,39,normal,2
2015-10-22 02:15:00,11,3,1,39,54,normal,2
2015-10-22 02:30:00,14,5,0,10,29,low,1
2015-10-22 02:45:00,20,0,1,33,54,normal,2
2015-10-22 03:00:00,13,1,1,33,48,normal,2
2015-10-22 03:15:00,18,2,1,12,33,low,1
2015-10-22 03:30:00,19,2,1,23,45,normal,2
2015-10-22 03:45:00,10,4,0,36,50,normal,2
2015-10-22 04:00:00,13,4,0,17,34,normal,2
2015-10-22 04:15:00,86,28,2,18,134,normal,2
2015-10-22 04:30:00,59,29,9,14,111,normal,2
2015-10-22 04:45:00,102,20,9,13,144,normal,2
2015-10-22 05:00:00,114,28,8,16,166,normal,2
2015-10-22 05:15:00,87,23,5,0,115,normal,2
2015-10-22 05:30:00,88,5,8,13,114,normal,2
2015-10-22 05:45:00,83,6,4,9,102,low,1
2015-10-22 06:00:00,150,19,24,3,196,heavy,4
2015-10-22 06:15:00,148,35,46,1,230,heavy,4
2015-10-22 06:30:00,146,23,23,4,196,heavy,4
2015-10-22 06:45:00,140,21,39,3,203,heavy,4
2015-10-22 07:00:00,149,36,35,1,221,heavy,4
2015-10-22 07:15:00,125,34,42,0,201,heavy,4
2015-10-22 07:30:00,147,34,20,5,206,heavy,4
2015-10-22 07:45:00,128,33,21,4,186,heavy,4
2015-10-22 08:00:00,111,38,50,5,204,heavy,4
2015-10-22 08:15:00,144,20,32,4,200,heavy,4
2015-10-22 08:30:00,121,14,23,1,159,normal,2
2015-10-22 08:45:00,136,36,40,4,216,heavy,4
2015-10-22 09:00:00,114,21,23,1,159,normal,2
2015-10-22 09:15:00,75,17,37,29,158,high,3
2015-10-22 09:30:00,34,5,27,22,88,normal,2
2015-10-22 09:45:00,45,6,7,15,73,normal,2
2015-10-22 10:00:00,65,10,6,27,108,normal,2
2015-10-22 10:15:00,67,25,20,18,130,normal,2
2015-10-22 10:30:00,50,25,25,28,128,high,3
2015-10-22 10:45:00,37,19,38,12,106,normal,2
2015-10-22 11:00:00,36,8,3,29,76,normal,2
2015-10-22 11:15:00,63,5,8,23,99,normal,2
2015-10-22 11:30:00,67,5,7,22,101,normal,2
2015-10-22 11:45:00,36,9,14,22,81,normal,2
2015-10-22 12:00:00,57,8,10,22,97,normal,2
2015-10-22 12:15:00,65,7,14,25,111,normal,2
2015-10-22 12:30:00,54,10,3,29,96,normal,2
2015-10-22 12:45:00,41,5,4,25,75,normal,2
2015-10-22 13:00:00,43,9,3,25,80,normal,2
2015-10-22 13:15:00,9,27,32,17,85,normal,2
2015-10-22 13:30:00,101,28,18,20,167,normal,2
2015-10-22 13:45:00,99,16,16,18,149,normal,2
2015-10-22 14:00:00,20,27,32,12,91,normal,2
2015-10-22 14:15:00,96,16,39,17,168,heavy,4
2015-10-22 14:30:00,62,28,18,20,128,normal,2
2015-10-22 14:45:00,58,27,17,5,107,normal,2
2015-10-22 15:00:00,60,18,28,12,118,high,3
2015-10-22 15:15:00,81,26,13,17,137,normal,2
2015-10-22 15:30:00,118,15,27,13,173,heavy,4
2015-10-22 15:45:00,53,12,25,20,110,normal,2
2015-10-22 16:00:00,132,12,27,9,180,heavy,4
2015-10-22 16:15:00,149,14,50,5,218,heavy,4
2015-10-22 16:30:00,106,35,41,5,187,heavy,4
2015-10-22 16:45:00,150,29,27,7,213,heavy,4
2015-10-22 17:00:00,110,30,46,5,191,heavy,4
2015-10-22 17:15:00,129,35,34,5,203,heavy,4
2015-10-22 17:30:00,133,21,26,5,185,heavy,4
2015-10-22 17:45:00,148,34,45,7,234,heavy,4
2015-10-22 18:00:00,144,39,43,8,234,heavy,4
2015-10-22 18:15:00,126,27,44,8,205,heavy,4
2015-10-22 18:30:00,103,34,49,5,191,heavy,4
2015-10-22 18:45:00,96,7,13,30,146,high,3
2015-10-22 19:00:00,54,17,17,19,107,normal,2
2015-10-22 19:15:00,98,16,17,15,146,normal,2
2015-10-22 19:30:00,72,6,19,8,105,normal,2
2015-10-22 19:45:00,69,23,12,31,135,high,3
2015-10-22 20:00:00,85,13,16,24,138,high,3
2015-10-22 20:15:00,102,22,12,9,145,normal,2
2015-10-22 20:30:00,103,14,20,14,151,normal,2
2015-10-22 20:45:00,80,12,10,22,124,high,3
2015-10-22 21:00:00,63,18,11,5,97,low,1
2015-10-22 21:15:00,84,21,13,9,127,normal,2
2015-10-22 21:30:00,72,10,10,29,121,high,3
2015-10-22 21:45:00,79,22,17,13,131,normal,2
2015-10-22 22:00:00,12,5,0,27,44,normal,2
2015-10-22 22:15:00,19,1,1,38,59,normal,2
2015-10-22 22:30:00,14,3,0,33,50,normal,2
2015-10-22 22:45:00,16,3,1,37,57,normal,2
2015-10-22 23:00:00,14,5,0,37,56,normal,2
2015-10-22 23:15:00,11,2,1,20,34,normal,2
2015-10-22 23:30:00,20,3,0,25,48,normal,2
2015-10-22 23:45:00,20,0,1,30,51,normal,2
2015-10-23 00:00:00,13,2,1,17,33,normal,2
2015-10-23 00:15:00,20,1,1,19,41,normal,2
2015-10-23 00:30:00,10,2,1,12,25,low,1
2015-10-23 00:45:00,14,2,0,25,41,normal,2
2015-10-23 01:00:00,12,0,1,16,29,normal,2
2015-10-23 01:15:00,11,5,1,31,48,normal,2
2015-10-23 01:30:00,13,1,1,16,31,normal,2
2015-10-23 01:45:00,17,3,0,10,30,low,1
2015-10-23 02:00:00,11,1,0,22,34,normal,2
2015-10-23 02:15:00,10,4,1,16,31,normal,2
2015-10-23 02:30:00,15,3,1,32,51,normal,2
2015-10-23 02:45:00,10,0,0,22,32,normal,2
2015-10-23 03:00:00,20,1,1,16,38,normal,2
2015-10-23 03:15:00,16,1,1,15,33,normal,2
2015-10-23 03:30:00,14,4,1,32,51,normal,2
2015-10-23 03:45:00,16,1,1,37,55,normal,2
2015-10-23 04:00:00,10,2,1,36,49,normal,2
2015-10-23 04:15:00,96,18,7,2,123,normal,2
2015-10-23 04:30:00,51,14,0,5,70,low,1
2015-10-23 04:45:00,63,25,2,8,98,low,1
2015-10-23 05:00:00,72,7,1,4,84,low,1
2015-10-23 05:15:00,86,18,6,1,111,low,1
2015-10-23 05:30:00,105,4,4,20,133,normal,2
2015-10-23 05:45:00,117,10,10,18,155,normal,2
2015-10-23 06:00:00,120,36,32,0,188,heavy,4
2015-10-23 06:15:00,135,20,31,0,186,heavy,4
2015-10-23 06:30:00,112,40,42,3,197,heavy,4
2015-10-23 06:45:00,135,13,20,3,171,heavy,4
2015-10-23 07:00:00,105,35,24,2,166,normal,2
2015-10-23 07:15:00,150,25,36,0,211,heavy,4
2015-10-23 07:30:00,108,27,23,2,160,normal,2
2015-10-23 07:45:00,108,40,45,1,194,heavy,4
2015-10-23 08:00:00,118,19,21,1,159,normal,2
2015-10-23 08:15:00,131,18,41,1,191,heavy,4
2015-10-23 08:30:00,148,31,20,4,203,heavy,4
2015-10-23 08:45:00,120,26,22,1,169,heavy,4
2015-10-23 09:00:00,147,12,32,0,191,heavy,4
2015-10-23 09:15:00,73,9,35,12,129,high,3
2015-10-23 09:30:00,93,21,22,29,165,high,3
2015-10-23 09:45:00,66,2,10,28,106,normal,2
2015-10-23 10:00:00,18,6,6,6,36,low,1
2015-10-23 10:15:00,78,1,16,30,125,high,3
2015-10-23 10:30:00,69,15,24,20,128,normal,2
2015-10-23 10:45:00,82,2,40,17,141,high,3
2015-10-23 11:00:00,57,9,5,23,94,normal,2
2015-10-23 11:15:00,25,5,14,26,70,normal,2
2015-10-23 11:30:00,40,9,15,28,92,normal,2
2015-10-23 11:45:00,52,6,13,21,92,normal,2
2015-10-23 12:00:00,45,8,13,29,95,normal,2
2015-10-23 12:15:00,67,10,7,25,109,normal,2
2015-10-23 12:30:00,20,8,14,30,72,normal,2
2015-10-23 12:45:00,44,8,4,29,85,normal,2
2015-10-23 13:00:00,63,5,8,29,105,normal,2
2015-10-23 13:15:00,119,15,20,13,167,normal,2
2015-10-23 13:30:00,103,10,23,7,143,normal,2
2015-10-23 13:45:00,42,14,15,14,85,normal,2
2015-10-23 14:00:00,67,20,24,12,123,normal,2
2015-10-23 14:15:00,56,18,29,17,120,high,3
2015-10-23 14:30:00,65,16,32,15,128,high,3
2015-10-23 14:45:00,107,11,26,19,163,high,3
2015-10-23 15:00:00,11,18,22,10,61,normal,2
2015-10-23 15:15:00,28,15,27,12,82,normal,2
2015-10-23 15:30:00,45,17,7,6,75,low,1
2015-10-23 15:45:00,66,12,27,6,111,normal,2
2015-10-23 16:00:00,104,40,22,9,175,heavy,4
2015-10-23 16:15:00,113,21,26,5,165,high,3
2015-10-23 16:30:00,120,29,37,6,192,heavy,4
2015-10-23 16:45:00,129,10,39,6,184,heavy,4
2015-10-23 17:00:00,119,29,40,10,198,heavy,4
2015-10-23 17:15:00,119,25,32,9,185,heavy,4
2015-10-23 17:30:00,123,10,30,7,170,heavy,4
2015-10-23 17:45:00,111,33,28,5,177,heavy,4
2015-10-23 18:00:00,110,12,47,8,177,heavy,4
2015-10-23 18:15:00,139,15,43,9,206,heavy,4
2015-10-23 18:30:00,132,29,25,7,193,heavy,4
2015-10-23 18:45:00,51,8,18,18,95,normal,2
2015-10-23 19:00:00,76,5,14,20,115,normal,2
2015-10-23 19:15:00,53,15,13,23,104,normal,2
2015-10-23 19:30:00,50,25,19,9,103,normal,2
2015-10-23 19:45:00,86,24,20,34,164,high,3
2015-10-23 20:00:00,67,23,14,13,117,normal,2
2015-10-23 20:15:00,54,9,15,7,85,low,1
2015-10-23 20:30:00,59,12,16,35,122,high,3
2015-10-23 20:45:00,109,25,15,5,154,normal,2
2015-10-23 21:00:00,73,18,10,35,136,high,3
2015-10-23 21:15:00,65,24,14,19,122,normal,2
2015-10-23 21:30:00,94,10,11,22,137,high,3
2015-10-23 21:45:00,106,9,12,31,158,high,3
2015-10-23 22:00:00,18,3,0,11,32,low,1
2015-10-23 22:15:00,17,1,1,36,55,normal,2
2015-10-23 22:30:00,12,0,0,22,34,normal,2
2015-10-23 22:45:00,11,1,0,19,31,normal,2
2015-10-23 23:00:00,16,1,0,32,49,normal,2
2015-10-23 23:15:00,12,3,1,13,29,normal,2
2015-10-23 23:30:00,14,4,1,27,46,normal,2
2015-10-23 23:45:00,11,3,1,37,52,normal,2
2015-10-24 00:00:00,17,2,0,18,37,normal,2
2015-10-24 00:15:00,18,4,1,39,62,normal,2
2015-10-24 00:30:00,20,4,0,32,56,normal,2
2015-10-24 00:45:00,15,0,0,28,43,normal,2
2015-10-24 01:00:00,11,4,0,12,27,low,1
2015-10-24 01:15:00,19,5,1,35,60,normal,2
2015-10-24 01:30:00,15,0,1,26,42,normal,2
2015-10-24 01:45:00,11,4,0,31,46,normal,2
2015-10-24 02:00:00,19,2,1,33,55,normal,2
2015-10-24 02:15:00,12,4,1,29,46,normal,2
2015-10-24 02:30:00,15,5,1,16,37,normal,2
2015-10-24 02:45:00,14,4,1,21,40,normal,2
2015-10-24 03:00:00,19,4,1,17,41,normal,2
2015-10-24 03:15:00,10,2,1,12,25,low,1
2015-10-24 03:30:00,10,0,0,11,21,low,1
2015-10-24 03:45:00,20,4,1,33,58,normal,2
2015-10-24 04:00:00,10,1,0,12,23,low,1
2015-10-24 04:15:00,73,12,5,5,95,low,1
2015-10-24 04:30:00,95,15,4,19,133,normal,2
2015-10-24 04:45:00,81,19,3,13,116,normal,2
2015-10-24 05:00:00,119,25,10,9,163,normal,2
2015-10-24 05:15:00,80,10,4,15,109,normal,2
2015-10-24 05:30:00,102,24,3,16,145,normal,2
2015-10-24 05:45:00,68,17,6,10,101,low,1
2015-10-24 06:00:00,109,40,38,0,187,heavy,4
2015-10-24 06:15:00,124,25,31,1,181,heavy,4
2015-10-24 06:30:00,126,22,21,1,170,heavy,4
2015-10-24 06:45:00,120,31,29,5,185,heavy,4
2015-10-24 07:00:00,101,20,47,5,173,heavy,4
2015-10-24 07:15:00,139,40,48,2,229,heavy,4
2015-10-24 07:30:00,116,23,23,4,166,normal,2
2015-10-24 07:45:00,101,14,24,0,139,normal,2
2015-10-24 08:00:00,137,40,21,5,203,heavy,4
2015-10-24 08:15:00,131,26,36,0,193,heavy,4
2015-10-24 08:30:00,114,27,45,4,190,heavy,4
2015-10-24 08:45:00,102,14,46,1,163,high,3
2015-10-24 09:00:00,116,24,32,5,177,heavy,4
2015-10-24 09:15:00,29,10,21,12,72,normal,2
2015-10-24 09:30:00,41,12,15,10,78,low,1
2015-10-24 09:45:00,41,9,7,27,84,normal,2
2015-10-24 10:00:00,90,25,26,10,151,high,3
2015-10-24 10:15:00,64,25,17,20,126,normal,2
2015-10-24 10:30:00,64,10,17,23,114,high,3
2015-10-24 10:45:00,69,17,5,28,119,high,3
2015-10-24 11:00:00,59,9,9,21,98,normal,2
2015-10-24 11:15:00,44,10,12,29,95,normal,2
2015-10-24 11:30:00,43,5,6,26,80,normal,2
2015-10-24 11:45:00,65,7,10,21,103,normal,2
2015-10-24 12:00:00,29,5,12,21,67,normal,2
2015-10-24 12:15:00,24,9,8,20,61,normal,2
2015-10-24 12:30:00,44,6,4,26,80,normal,2
2015-10-24 12:45:00,35,10,12,24,81,normal,2
2015-10-24 13:00:00,43,10,15,21,89,normal,2
2015-10-24 13:15:00,45,17,24,11,97,normal,2
2015-10-24 13:30:00,108,21,37,14,180,heavy,4
2015-10-24 13:45:00,53,19,33,9,114,high,3
2015-10-24 14:00:00,75,23,31,13,142,high,3
2015-10-24 14:15:00,70,18,5,19,112,normal,2
2015-10-24 14:30:00,52,25,15,19,111,normal,2
2015-10-24 14:45:00,9,18,24,9,60,normal,2
2015-10-24 15:00:00,47,21,9,18,95,normal,2
2015-10-24 15:15:00,116,20,17,19,172,heavy,4
2015-10-24 15:30:00,65,14,6,9,94,low,1
2015-10-24 15:45:00,93,12,13,13,131,normal,2
2015-10-24 16:00:00,100,21,45,9,175,heavy,4
2015-10-24 16:15:00,121,24,31,6,182,heavy,4
2015-10-24 16:30:00,110,15,50,5,180,heavy,4
2015-10-24 16:45:00,103,17,28,5,153,high,3
2015-10-24 17:00:00,136,38,20,5,199,heavy,4
2015-10-24 17:15:00,119,22,32,9,182,heavy,4
2015-10-24 17:30:00,132,17,36,5,190,heavy,4
2015-10-24 17:45:00,147,10,41,5,203,heavy,4
2015-10-24 18:00:00,111,12,44,6,173,heavy,4
2015-10-24 18:15:00,102,27,32,5,166,high,3
2015-10-24 18:30:00,137,25,29,7,198,heavy,4
2015-10-24 18:45:00,71,17,15,31,134,high,3
2015-10-24 19:00:00,64,25,11,15,115,normal,2
2015-10-24 19:15:00,70,16,15,29,130,high,3
2015-10-24 19:30:00,91,9,11,32,143,high,3
2015-10-24 19:45:00,95,6,11,35,147,high,3
2015-10-24 20:00:00,76,16,10,31,133,high,3
2015-10-24 20:15:00,87,17,18,7,129,normal,2
2015-10-24 20:30:00,63,22,12,29,126,high,3
2015-10-24 20:45:00,56,17,20,8,101,normal,2
2015-10-24 21:00:00,102,18,19,29,168,heavy,4
2015-10-24 21:15:00,60,23,10,13,106,normal,2
2015-10-24 21:30:00,88,6,18,25,137,high,3
2015-10-24 21:45:00,104,15,10,32,161,high,3
2015-10-24 22:00:00,16,1,1,26,44,normal,2
2015-10-24 22:15:00,12,1,0,12,25,low,1
2015-10-24 22:30:00,16,1,0,29,46,normal,2
2015-10-24 22:45:00,13,5,0,31,49,normal,2
2015-10-24 23:00:00,20,1,1,27,49,normal,2
2015-10-24 23:15:00,18,0,0,29,47,normal,2
2015-10-24 23:30:00,16,3,1,26,46,normal,2
2015-10-24 23:45:00,18,0,0,21,39,normal,2
2015-10-25 00:00:00,11,5,0,24,40,normal,2
2015-10-25 00:15:00,13,1,0,10,24,low,1
2015-10-25 00:30:00,10,1,0,26,37,normal,2
2015-10-25 00:45:00,19,5,1,22,47,normal,2
2015-10-25 01:00:00,20,0,0,10,30,low,1
2015-10-25 01:15:00,16,4,1,39,60,normal,2
2015-10-25 01:30:00,19,1,1,11,32,low,1
2015-10-25 01:45:00,20,4,0,38,62,normal,2
2015-10-25 02:00:00,15,1,1,15,32,normal,2
2015-10-25 02:15:00,10,0,0,33,43,normal,2
2015-10-25 02:30:00,20,5,0,24,49,normal,2
2015-10-25 02:45:00,12,2,1,35,50,normal,2
2015-10-25 03:00:00,10,4,1,37,52,normal,2
2015-10-25 03:15:00,15,4,0,38,57,normal,2
2015-10-25 03:30:00,19,0,1,39,59,normal,2
2015-10-25 03:45:00,16,4,0,35,55,normal,2
2015-10-25 04:00:00,20,3,1,35,59,normal,2
2015-10-25 04:15:00,118,1,0,4,123,normal,2
2015-10-25 04:30:00,89,20,4,17,130,normal,2
2015-10-25 04:45:00,120,18,6,13,157,normal,2
2015-10-25 05:00:00,85,7,3,18,113,normal,2
2015-10-25 05:15:00,99,8,2,14,123,normal,2
2015-10-25 05:30:00,59,25,2,7,93,low,1
2015-10-25 05:45:00,58,25,2,5,90,low,1
2015-10-25 06:00:00,113,40,36,4,193,heavy,4
2015-10-25 06:15:00,113,16,50,2,181,heavy,4
2015-10-25 06:30:00,121,27,50,4,202,heavy,4
2015-10-25 06:45:00,150,17,28,0,195,heavy,4
2015-10-25 07:00:00,136,29,23,0,188,heavy,4
2015-10-25 07:15:00,142,32,27,2,203,heavy,4
2015-10-25 07:30:00,106,32,42,2,182,heavy,4
2015-10-25 07:45:00,103,21,20,0,144,normal,2
2015-10-25 08:00:00,131,19,26,1,177,heavy,4
2015-10-25 08:15:00,133,23,21,3,180,heavy,4
2015-10-25 08:30:00,123,17,50,1,191,heavy,4
2015-10-25 08:45:00,124,21,35,2,182,heavy,4
2015-10-25 09:00:00,136,26,20,4,186,heavy,4
2015-10-25 09:15:00,92,10,39,19,160,high,3
2015-10-25 09:30:00,82,7,13,19,121,normal,2
2015-10-25 09:45:00,42,2,28,27,99,normal,2
2015-10-25 10:00:00,24,17,17,9,67,normal,2
2015-10-25 10:15:00,42,19,17,12,90,normal,2
2015-10-25 10:30:00,100,12,5,23,140,high,3
2015-10-25 10:45:00,11,25,30,22,88,normal,2
2015-10-25 11:00:00,27,7,10,22,66,normal,2
2015-10-25 11:15:00,38,7,11,20,76,normal,2
2015-10-25 11:30:00,49,10,6,27,92,normal,2
2015-10-25 11:45:00,66,9,7,28,110,normal,2
2015-10-25 12:00:00,70,8,3,22,103,normal,2
2015-10-25 12:15:00,58,7,6,27,98,normal,2
2015-10-25 12:30:00,53,9,13,29,104,normal,2
2015-10-25 12:45:00,22,5,6,26,59,normal,2
2015-10-25 13:00:00,40,10,11,28,89,normal,2
2015-10-25 13:15:00,58,13,10,12,93,low,1
2015-10-25 13:30:00,60,25,24,17,126,normal,2
2015-10-25 13:45:00,25,11,24,17,77,normal,2
2015-10-25 14:00:00,22,28,11,18,79,normal,2
2015-10-25 14:15:00,6,11,37,15,69,normal,2
2015-10-25 14:30:00,92,18,34,18,162,high,3
2015-10-25 14:45:00,97,17,38,20,172,heavy,4
2015-10-25 15:00:00,92,18,31,6,147,high,3
2015-10-25 15:15:00,74,12,17,16,119,normal,2
2015-10-25 15:30:00,67,22,7,5,101,low,1
2015-10-25 15:45:00,84,20,25,15,144,normal,2
2015-10-25 16:00:00,144,15,42,8,209,heavy,4
2015-10-25 16:15:00,120,11,47,7,185,heavy,4
2015-10-25 16:30:00,108,10,36,6,160,high,3
2015-10-25 16:45:00,141,13,50,6,210,heavy,4
2015-10-25 17:00:00,121,37,29,8,195,heavy,4
2015-10-25 17:15:00,142,40,22,6,210,heavy,4
2015-10-25 17:30:00,137,23,28,7,195,heavy,4
2015-10-25 17:45:00,117,10,27,8,162,high,3
2015-10-25 18:00:00,100,16,37,7,160,high,3
2015-10-25 18:15:00,148,11,42,8,209,heavy,4
2015-10-25 18:30:00,148,27,39,6,220,heavy,4
2015-10-25 18:45:00,65,18,20,21,124,high,3
2015-10-25 19:00:00,75,9,14,6,104,low,1
2015-10-25 19:15:00,85,15,20,29,149,high,3
2015-10-25 19:30:00,57,21,20,18,116,normal,2
2015-10-25 19:45:00,50,7,13,30,100,normal,2
2015-10-25 20:00:00,87,21,14,34,156,high,3
2015-10-25 20:15:00,64,24,11,6,105,low,1
2015-10-25 20:30:00,76,6,18,14,114,normal,2
2015-10-25 20:45:00,69,11,12,8,100,low,1
2015-10-25 21:00:00,76,9,17,14,116,normal,2
2015-10-25 21:15:00,94,8,15,5,122,normal,2
2015-10-25 21:30:00,104,10,16,33,163,high,3
2015-10-25 21:45:00,98,13,13,33,157,high,3
2015-10-25 22:00:00,13,5,0,18,36,normal,2
2015-10-25 22:15:00,17,1,0,11,29,low,1
2015-10-25 22:30:00,18,2,1,34,55,normal,2
2015-10-25 22:45:00,11,1,0,35,47,normal,2
2015-10-25 23:00:00,17,4,0,11,32,low,1
2015-10-25 23:15:00,17,1,1,23,42,normal,2
2015-10-25 23:30:00,17,2,0,23,42,normal,2
2015-10-25 23:45:00,16,4,1,30,51,normal,2
2015-10-26 00:00:00,15,5,1,23,44,normal,2
2015-10-26 00:15:00,18,0,0,31,49,normal,2
2015-10-26 00:30:00,10,1,0,17,28,normal,2
2015-10-26 00:45:00,13,2,0,32,47,normal,2
2015-10-26 01:00:00,16,1,0,38,55,normal,2
2015-10-26 01:15:00,11,4,0,32,47,normal,2
2015-10-26 01:30:00,12,2,0,26,40,normal,2
2015-10-26 01:45:00,14,2,1,14,31,normal,2
2015-10-26 02:00:00,18,2,0,37,57,normal,2
2015-10-26 02:15:00,17,1,1,22,41,normal,2
2015-10-26 02:30:00,12,3,0,29,44,normal,2
2015-10-26 02:45:00,20,5,0,30,55,normal,2
2015-10-26 03:00:00,17,5,1,19,42,normal,2
2015-10-26 03:15:00,12,0,1,33,46,normal,2
2015-10-26 03:30:00,19,1,0,20,40,normal,2
2015-10-26 03:45:00,11,4,1,38,54,normal,2
2015-10-26 04:00:00,14,5,0,39,58,normal,2
2015-10-26 04:15:00,102,20,4,12,138,normal,2
2015-10-26 04:30:00,92,4,6,18,120,normal,2
2015-10-26 04:45:00,54,14,10,16,94,normal,2
2015-10-26 05:00:00,55,15,1,10,81,low,1
2015-10-26 05:15:00,64,27,5,5,101,low,1
2015-10-26 05:30:00,52,13,5,15,85,normal,2
2015-10-26 05:45:00,73,11,4,3,91,low,1
2015-10-26 06:00:00,106,27,45,5,183,heavy,4
2015-10-26 06:15:00,145,21,40,5,211,heavy,4
2015-10-26 06:30:00,133,19,28,5,185,heavy,4
2015-10-26 06:45:00,117,31,49,0,197,heavy,4
2015-10-26 07:00:00,146,17,34,0,197,heavy,4
2015-10-26 07:15:00,101,35,42,3,181,heavy,4
2015-10-26 07:30:00,103,28,32,1,164,high,3
2015-10-26 07:45:00,150,10,26,0,186,heavy,4
2015-10-26 08:00:00,135,23,48,0,206,heavy,4
2015-10-26 08:15:00,104,10,48,2,164,high,3
2015-10-26 08:30:00,144,39,50,1,234,heavy,4
2015-10-26 08:45:00,132,10,49,0,191,heavy,4
2015-10-26 09:00:00,142,19,31,1,193,heavy,4
2015-10-26 09:15:00,45,4,30,29,108,normal,2
2015-10-26 09:30:00,27,24,10,5,66,low,1
2015-10-26 09:45:00,85,3,14,16,118,normal,2
2015-10-26 10:00:00,84,11,27,26,148,high,3
2015-10-26 10:15:00,90,4,10,20,124,normal,2
2015-10-26 10:30:00,13,19,39,12,83,normal,2
2015-10-26 10:45:00,11,1,37,9,58,normal,2
2015-10-26 11:00:00,57,10,4,27,98,normal,2
2015-10-26 11:15:00,52,10,9,23,94,normal,2
2015-10-26 11:30:00,38,7,13,21,79,normal,2
2015-10-26 11:45:00,35,7,15,24,81,normal,2
2015-10-26 12:00:00,60,10,12,21,103,normal,2
2015-10-26 12:15:00,70,10,3,30,113,high,3
2015-10-26 12:30:00,34,8,6,30,78,normal,2
2015-10-26 12:45:00,44,6,4,27,81,normal,2
2015-10-26 13:00:00,21,5,4,25,55,normal,2
2015-10-26 13:15:00,106,10,11,11,138,normal,2
2015-10-26 13:30:00,82,30,32,10,154,high,3
2015-10-26 13:45:00,57,12,9,17,95,normal,2
2015-10-26 14:00:00,60,18,21,10,109,normal,2
2015-10-26 14:15:00,79,17,34,8,138,high,3
2015-10-26 14:30:00,78,29,22,13,142,normal,2
2015-10-26 14:45:00,69,14,32,18,133,high,3
2015-10-26 15:00:00,84,25,5,9,123,normal,2
2015-10-26 15:15:00,62,11,28,5,106,normal,2
2015-10-26 15:30:00,33,17,22,18,90,normal,2
2015-10-26 15:45:00,14,21,23,6,64,normal,2
2015-10-26 16:00:00,127,27,40,5,199,heavy,4
2015-10-26 16:15:00,136,10,27,7,180,heavy,4
2015-10-26 16:30:00,148,14,37,9,208,heavy,4
2015-10-26 16:45:00,122,16,28,6,172,heavy,4
2015-10-26 17:00:00,132,12,45,9,198,heavy,4
2015-10-26 17:15:00,136,29,29,10,204,heavy,4
2015-10-26 17:30:00,103,33,48,10,194,heavy,4
2015-10-26 17:45:00,132,37,23,10,202,heavy,4
2015-10-26 18:00:00,136,39,39,6,220,heavy,4
2015-10-26 18:15:00,120,24,36,5,185,heavy,4
2015-10-26 18:30:00,126,34,38,9,207,heavy,4
2015-10-26 18:45:00,80,22,14,18,134,normal,2
2015-10-26 19:00:00,99,9,15,29,152,high,3
2015-10-26 19:15:00,81,21,19,7,128,normal,2
2015-10-26 19:30:00,87,9,16,26,138,high,3
2015-10-26 19:45:00,80,17,13,30,140,high,3
2015-10-26 20:00:00,91,18,18,9,136,normal,2
2015-10-26 20:15:00,90,19,15,13,137,normal,2
2015-10-26 20:30:00,107,19,10,23,159,high,3
2015-10-26 20:45:00,98,11,14,27,150,high,3
2015-10-26 21:00:00,98,18,20,22,158,high,3
2015-10-26 21:15:00,102,5,12,17,136,normal,2
2015-10-26 21:30:00,62,13,16,28,119,high,3
2015-10-26 21:45:00,101,15,12,35,163,high,3
2015-10-26 22:00:00,17,5,1,16,39,normal,2
2015-10-26 22:15:00,10,4,1,37,52,normal,2
2015-10-26 22:30:00,16,4,0,35,55,normal,2
2015-10-26 22:45:00,17,2,0,17,36,normal,2
2015-10-26 23:00:00,17,0,0,27,44,normal,2
2015-10-26 23:15:00,17,4,1,25,47,normal,2
2015-10-26 23:30:00,15,2,0,15,32,normal,2
2015-10-26 23:45:00,20,0,1,12,33,low,1
2015-10-27 00:00:00,16,3,0,28,47,normal,2
2015-10-27 00:15:00,13,2,1,28,44,normal,2
2015-10-27 00:30:00,15,5,0,26,46,normal,2
2015-10-27 00:45:00,15,2,1,16,34,normal,2
2015-10-27 01:00:00,12,3,0,26,41,normal,2
2015-10-27 01:15:00,15,5,0,27,47,normal,2
2015-10-27 01:30:00,20,2,0,17,39,normal,2
2015-10-27 01:45:00,12,2,0,16,30,normal,2
2015-10-27 02:00:00,19,1,0,38,58,normal,2
2015-10-27 02:15:00,16,1,1,32,50,normal,2
2015-10-27 02:30:00,12,0,0,11,23,low,1
2015-10-27 02:45:00,16,5,1,29,51,normal,2
2015-10-27 03:00:00,19,5,1,18,43,normal,2
2015-10-27 03:15:00,11,0,0,15,26,normal,2
2015-10-27 03:30:00,15,4,1,17,37,normal,2
2015-10-27 03:45:00,20,1,0,23,44,normal,2
2015-10-27 04:00:00,10,4,0,36,50,normal,2
2015-10-27 04:15:00,39,14,0,15,68,normal,2
2015-10-27 04:30:00,33,7,3,10,53,low,1
2015-10-27 04:45:00,77,8,7,15,107,normal,2
2015-10-27 05:00:00,80,18,6,11,115,normal,2
2015-10-27 05:15:00,53,11,7,15,86,normal,2
2015-10-27 05:30:00,73,17,6,13,109,normal,2
2015-10-27 05:45:00,77,20,4,13,114,normal,2
2015-10-27 06:00:00,76,14,1,12,103,low,1
2015-10-27 06:15:00,58,14,0,15,87,normal,2
2015-10-27 06:30:00,57,18,7,13,95,normal,2
2015-10-27 06:45:00,80,16,0,10,106,low,1
2015-10-27 07:00:00,38,7,1,13,59,normal,2
2015-10-27 07:15:00,53,20,6,12,91,low,1
2015-10-27 07:30:00,30,9,7,10,56,low,1
2015-10-27 07:45:00,50,19,4,10,83,low,1
2015-10-27 08:00:00,31,14,3,14,62,normal,2
2015-10-27 08:15:00,28,18,5,10,61,low,1
2015-10-27 08:30:00,31,15,4,12,62,low,1
2015-10-27 08:45:00,52,19,0,10,81,low,1
2015-10-27 09:00:00,42,9,2,13,66,normal,2
2015-10-27 09:15:00,151,55,27,2,235,heavy,4
2015-10-27 09:30:00,180,69,29,1,279,heavy,4
2015-10-27 09:45:00,149,41,23,3,216,heavy,4
2015-10-27 10:00:00,167,60,27,3,257,heavy,4
2015-10-27 10:15:00,134,45,22,3,204,heavy,4
2015-10-27 10:30:00,180,62,26,4,272,heavy,4
2015-10-27 10:45:00,156,54,25,3,238,heavy,4
2015-10-27 11:00:00,171,60,18,1,250,heavy,4
2015-10-27 11:15:00,174,53,10,3,240,heavy,4
2015-10-27 11:30:00,154,61,16,3,234,heavy,4
2015-10-27 11:45:00,161,53,11,1,226,heavy,4
2015-10-27 12:00:00,148,48,13,2,211,heavy,4
2015-10-27 12:15:00,136,60,27,2,225,heavy,4
2015-10-27 12:30:00,143,68,16,0,227,heavy,4
2015-10-27 12:45:00,152,51,22,2,227,heavy,4
2015-10-27 13:00:00,132,58,15,4,209,heavy,4
2015-10-27 13:15:00,155,58,15,4,232,heavy,4
2015-10-27 13:30:00,144,62,12,3,221,heavy,4
2015-10-27 13:45:00,161,51,20,1,233,heavy,4
2015-10-27 14:00:00,137,46,13,2,198,heavy,4
2015-10-27 14:15:00,149,61,16,1,227,heavy,4
2015-10-27 14:30:00,158,46,20,1,225,heavy,4
2015-10-27 14:45:00,134,65,22,0,221,heavy,4
2015-10-27 15:00:00,134,65,10,2,211,heavy,4
2015-10-27 15:15:00,73,24,4,0,101,low,1
2015-10-27 15:30:00,64,23,21,1,109,normal,2
2015-10-27 15:45:00,51,27,25,2,105,normal,2
2015-10-27 16:00:00,80,22,17,0,119,normal,2
2015-10-27 16:15:00,61,26,8,0,95,low,1
2015-10-27 16:30:00,75,24,8,0,107,low,1
2015-10-27 16:45:00,82,20,15,2,119,normal,2
2015-10-27 17:00:00,53,28,21,1,103,normal,2
2015-10-27 17:15:00,68,29,14,0,111,low,1
2015-10-27 17:30:00,63,28,22,0,113,normal,2
2015-10-27 17:45:00,76,30,20,1,127,normal,2
2015-10-27 18:00:00,66,23,10,0,99,low,1
2015-10-27 18:15:00,50,23,1,0,74,low,1
2015-10-27 18:30:00,60,29,22,2,113,normal,2
2015-10-27 18:45:00,75,26,11,0,112,normal,2
2015-10-27 19:00:00,81,22,18,2,123,normal,2
2015-10-27 19:15:00,33,6,0,4,43,low,1
2015-10-27 19:30:00,21,5,6,15,47,normal,2
2015-10-27 19:45:00,22,7,1,2,32,low,1
2015-10-27 20:00:00,31,6,0,15,52,normal,2
2015-10-27 20:15:00,41,8,3,2,54,low,1
2015-10-27 20:30:00,24,6,5,11,46,low,1
2015-10-27 20:45:00,45,6,6,10,67,low,1
2015-10-27 21:00:00,24,11,6,2,43,low,1
2015-10-27 21:15:00,47,6,2,12,67,low,1
2015-10-27 21:30:00,46,1,1,4,52,low,1
2015-10-27 21:45:00,26,3,2,3,34,low,1
2015-10-27 22:00:00,20,4,0,39,63,normal,2
2015-10-27 22:15:00,20,1,1,27,49,normal,2
2015-10-27 22:30:00,19,0,1,17,37,normal,2
2015-10-27 22:45:00,11,3,1,19,34,normal,2
2015-10-27 23:00:00,17,5,1,31,54,normal,2
2015-10-27 23:15:00,19,4,0,12,35,low,1
2015-10-27 23:30:00,11,1,0,38,50,normal,2
2015-10-27 23:45:00,12,0,0,17,29,normal,2
2015-10-28 00:00:00,18,0,0,27,45,normal,2
2015-10-28 00:15:00,19,4,0,14,37,normal,2
2015-10-28 00:30:00,13,2,0,28,43,normal,2
2015-10-28 00:45:00,18,4,1,23,46,normal,2
2015-10-28 01:00:00,20,0,0,11,31,low,1
2015-10-28 01:15:00,11,4,1,22,38,normal,2
2015-10-28 01:30:00,15,2,0,18,35,normal,2
2015-10-28 01:45:00,16,3,0,34,53,normal,2
2015-10-28 02:00:00,11,2,0,18,31,normal,2
2015-10-28 02:15:00,17,4,1,38,60,normal,2
2015-10-28 02:30:00,20,4,1,28,53,normal,2
2015-10-28 02:45:00,19,0,1,37,57,normal,2
2015-10-28 03:00:00,10,2,1,34,47,normal,2
2015-10-28 03:15:00,19,0,0,17,36,normal,2
2015-10-28 03:30:00,15,0,0,30,45,normal,2
2015-10-28 03:45:00,10,2,0,31,43,normal,2
2015-10-28 04:00:00,18,3,0,17,38,normal,2
2015-10-28 04:15:00,97,22,4,18,141,normal,2
2015-10-28 04:30:00,111,12,9,17,149,normal,2
2015-10-28 04:45:00,108,10,5,17,140,normal,2
2015-10-28 05:00:00,74,24,10,20,128,normal,2
2015-10-28 05:15:00,114,4,8,20,146,normal,2
2015-10-28 05:30:00,91,16,5,11,123,normal,2
2015-10-28 05:45:00,66,3,9,19,97,normal,2
2015-10-28 06:00:00,104,32,23,5,164,normal,2
2015-10-28 06:15:00,128,18,31,3,180,heavy,4
2015-10-28 06:30:00,127,24,27,0,178,heavy,4
2015-10-28 06:45:00,130,31,22,0,183,heavy,4
2015-10-28 07:00:00,108,13,38,1,160,high,3
2015-10-28 07:15:00,116,22,37,2,177,heavy,4
2015-10-28 07:30:00,143,28,27,4,202,heavy,4
2015-10-28 07:45:00,118,32,21,5,176,heavy,4
2015-10-28 08:00:00,121,35,32,0,188,heavy,4
2015-10-28 08:15:00,109,28,39,2,178,heavy,4
2015-10-28 08:30:00,135,11,23,5,174,heavy,4
2015-10-28 08:45:00,100,30,29,2,161,high,3
2015-10-28 09:00:00,138,32,26,4,200,heavy,4
2015-10-28 09:15:00,29,9,21,23,82,normal,2
2015-10-28 09:30:00,36,17,7,30,90,normal,2
2015-10-28 09:45:00,42,9,37,28,116,high,3
2015-10-28 10:00:00,80,6,12,6,104,low,1
2015-10-28 10:15:00,37,21,28,6,92,normal,2
2015-10-28 10:30:00,44,17,27,30,118,high,3
2015-10-28 10:45:00,25,12,13,5,55,low,1
2015-10-28 11:00:00,36,9,9,30,84,normal,2
2015-10-28 11:15:00,63,7,10,29,109,normal,2
2015-10-28 11:30:00,20,5,13,22,60,normal,2
2015-10-28 11:45:00,53,8,6,23,90,normal,2
2015-10-28 12:00:00,41,7,5,26,79,normal,2
2015-10-28 12:15:00,36,9,13,29,87,normal,2
2015-10-28 12:30:00,65,10,8,22,105,normal,2
2015-10-28 12:45:00,55,6,5,27,93,normal,2
2015-10-28 13:00:00,63,8,15,30,116,high,3
2015-10-28 13:15:00,19,26,32,18,95,normal,2
2015-10-28 13:30:00,84,11,11,9,115,normal,2
2015-10-28 13:45:00,110,23,34,9,176,heavy,4
2015-10-28 14:00:00,46,20,18,5,89,normal,2
2015-10-28 14:15:00,67,12,10,20,109,normal,2
2015-10-28 14:30:00,42,25,20,19,106,normal,2
2015-10-28 14:45:00,87,17,18,6,128,normal,2
2015-10-28 15:00:00,45,24,31,11,111,normal,2
2015-10-28 15:15:00,80,26,35,6,147,high,3
2015-10-28 15:30:00,83,18,6,15,122,normal,2
2015-10-28 15:45:00,68,19,15,11,113,normal,2
2015-10-28 16:00:00,101,37,48,9,195,heavy,4
2015-10-28 16:15:00,149,32,29,10,220,heavy,4
2015-10-28 16:30:00,136,21,33,9,199,heavy,4
2015-10-28 16:45:00,105,20,23,7,155,normal,2
2015-10-28 17:00:00,125,12,20,8,165,normal,2
2015-10-28 17:15:00,125,14,26,5,170,heavy,4
2015-10-28 17:30:00,118,28,23,8,177,heavy,4
2015-10-28 17:45:00,114,32,45,6,197,heavy,4
2015-10-28 18:00:00,123,37,46,8,214,heavy,4
2015-10-28 18:15:00,115,23,22,7,167,normal,2
2015-10-28 18:30:00,111,25,35,10,181,heavy,4
2015-10-28 18:45:00,66,8,11,9,94,low,1
2015-10-28 19:00:00,103,12,17,23,155,high,3
2015-10-28 19:15:00,94,14,14,24,146,high,3
2015-10-28 19:30:00,105,23,15,18,161,normal,2
2015-10-28 19:45:00,53,22,14,35,124,high,3
2015-10-28 20:00:00,74,10,12,32,128,high,3
2015-10-28 20:15:00,71,24,15,26,136,high,3
2015-10-28 20:30:00,61,21,15,32,129,high,3
2015-10-28 20:45:00,101,25,18,8,152,normal,2
2015-10-28 21:00:00,104,22,10,14,150,normal,2
2015-10-28 21:15:00,79,20,15,18,132,normal,2
2015-10-28 21:30:00,70,20,11,14,115,normal,2
2015-10-28 21:45:00,74,16,14,34,138,high,3
2015-10-28 22:00:00,20,5,0,21,46,normal,2
2015-10-28 22:15:00,16,0,0,36,52,normal,2
2015-10-28 22:30:00,14,3,0,20,37,normal,2
2015-10-28 22:45:00,14,1,1,30,46,normal,2
2015-10-28 23:00:00,17,0,1,12,30,low,1
2015-10-28 23:15:00,14,0,0,14,28,normal,2
2015-10-28 23:30:00,18,5,0,40,63,normal,2
2015-10-28 23:45:00,17,2,0,18,37,normal,2
2015-10-29 00:00:00,14,1,1,35,51,normal,2
2015-10-29 00:15:00,14,2,1,26,43,normal,2
2015-10-29 00:30:00,16,0,1,37,54,normal,2
2015-10-29 00:45:00,14,4,1,32,51,normal,2
2015-10-29 01:00:00,19,5,0,12,36,low,1
2015-10-29 01:15:00,11,0,1,31,43,normal,2
2015-10-29 01:30:00,12,0,0,32,44,normal,2
2015-10-29 01:45:00,12,3,0,32,47,normal,2
2015-10-29 02:00:00,18,4,1,31,54,normal,2
2015-10-29 02:15:00,17,4,1,20,42,normal,2
2015-10-29 02:30:00,17,0,0,22,39,normal,2
2015-10-29 02:45:00,19,2,1,12,34,low,1
2015-10-29 03:00:00,18,2,1,19,40,normal,2
2015-10-29 03:15:00,19,5,0,26,50,normal,2
2015-10-29 03:30:00,19,5,1,35,60,normal,2
2015-10-29 03:45:00,18,0,0,20,38,normal,2
2015-10-29 04:00:00,16,0,0,30,46,normal,2
2015-10-29 04:15:00,114,30,9,7,160,normal,2
2015-10-29 04:30:00,102,17,2,14,135,normal,2
2015-10-29 04:45:00,55,4,7,13,79,normal,2
2015-10-29 05:00:00,82,2,4,14,102,normal,2
2015-10-29 05:15:00,66,16,9,19,110,normal,2
2015-10-29 05:30:00,86,5,1,13,105,normal,2
2015-10-29 05:45:00,108,24,2,19,153,normal,2
2015-10-29 06:00:00,112,30,26,0,168,heavy,4
2015-10-29 06:15:00,147,31,46,0,224,heavy,4
2015-10-29 06:30:00,116,20,40,2,178,heavy,4
2015-10-29 06:45:00,138,13,21,5,177,heavy,4
2015-10-29 07:00:00,132,25,40,2,199,heavy,4
2015-10-29 07:15:00,124,14,31,4,173,heavy,4
2015-10-29 07:30:00,106,27,25,1,159,normal,2
2015-10-29 07:45:00,104,24,29,5,162,high,3
2015-10-29 08:00:00,140,31,21,4,196,heavy,4
2015-10-29 08:15:00,121,35,37,3,196,heavy,4
2015-10-29 08:30:00,135,23,37,5,200,heavy,4
2015-10-29 08:45:00,149,20,30,5,204,heavy,4
2015-10-29 09:00:00,117,14,39,0,170,heavy,4
2015-10-29 09:15:00,39,8,23,13,83,normal,2
2015-10-29 09:30:00,40,14,18,21,93,normal,2
2015-10-29 09:45:00,49,1,35,18,103,normal,2
2015-10-29 10:00:00,38,12,35,25,110,normal,2
2015-10-29 10:15:00,26,15,25,6,72,normal,2
2015-10-29 10:30:00,93,14,10,25,142,high,3
2015-10-29 10:45:00,54,24,37,20,135,high,3
2015-10-29 11:00:00,32,6,10,23,71,normal,2
2015-10-29 11:15:00,43,7,12,23,85,normal,2
2015-10-29 11:30:00,23,6,15,20,64,normal,2
2015-10-29 11:45:00,26,5,8,25,64,normal,2
2015-10-29 12:00:00,55,7,8,27,97,normal,2
2015-10-29 12:15:00,70,10,8,25,113,high,3
2015-10-29 12:30:00,66,10,3,29,108,normal,2
2015-10-29 12:45:00,66,7,15,26,114,high,3
2015-10-29 13:00:00,46,6,7,21,80,normal,2
2015-10-29 13:15:00,47,26,6,20,99,normal,2
2015-10-29 13:30:00,75,20,7,11,113,normal,2
2015-10-29 13:45:00,76,29,15,19,139,normal,2
2015-10-29 14:00:00,56,14,38,12,120,high,3
2015-10-29 14:15:00,19,26,36,17,98,normal,2
2015-10-29 14:30:00,29,18,10,9,66,low,1
2015-10-29 14:45:00,15,12,18,15,60,normal,2
2015-10-29 15:00:00,53,27,27,17,124,high,3
2015-10-29 15:15:00,95,22,28,9,154,high,3
2015-10-29 15:30:00,27,27,32,10,96,normal,2
2015-10-29 15:45:00,68,28,31,15,142,high,3
2015-10-29 16:00:00,120,14,25,8,167,normal,2
2015-10-29 16:15:00,144,28,24,8,204,heavy,4
2015-10-29 16:30:00,112,31,43,8,194,heavy,4
2015-10-29 16:45:00,149,28,20,10,207,heavy,4
2015-10-29 17:00:00,131,29,34,8,202,heavy,4
2015-10-29 17:15:00,104,31,41,9,185,heavy,4
2015-10-29 17:30:00,141,30,27,7,205,heavy,4
2015-10-29 17:45:00,117,10,47,9,183,heavy,4
2015-10-29 18:00:00,112,13,37,6,168,heavy,4
2015-10-29 18:15:00,127,40,39,8,214,heavy,4
2015-10-29 18:30:00,131,15,31,6,183,heavy,4
2015-10-29 18:45:00,66,8,10,11,95,low,1
2015-10-29 19:00:00,61,23,18,34,136,high,3
2015-10-29 19:15:00,55,25,13,26,119,high,3
2015-10-29 19:30:00,85,23,20,6,134,normal,2
2015-10-29 19:45:00,75,20,19,19,133,normal,2
2015-10-29 20:00:00,58,17,20,22,117,high,3
2015-10-29 20:15:00,60,23,11,26,120,high,3
2015-10-29 20:30:00,80,21,11,7,119,normal,2
2015-10-29 20:45:00,74,9,14,35,132,high,3
2015-10-29 21:00:00,57,14,11,16,98,normal,2
2015-10-29 21:15:00,73,9,13,5,100,low,1
2015-10-29 21:30:00,80,25,19,26,150,high,3
2015-10-29 21:45:00,82,13,12,21,128,high,3
2015-10-29 22:00:00,15,4,0,27,46,normal,2
2015-10-29 22:15:00,20,2,0,29,51,normal,2
2015-10-29 22:30:00,12,2,0,39,53,normal,2
2015-10-29 22:45:00,10,4,1,13,28,normal,2
2015-10-29 23:00:00,16,0,1,29,46,normal,2
2015-10-29 23:15:00,18,0,0,34,52,normal,2
2015-10-29 23:30:00,11,5,1,19,36,normal,2
2015-10-29 23:45:00,16,1,0,12,29,low,1
2015-10-30 00:00:00,13,3,1,12,29,low,1
2015-10-30 00:15:00,19,2,0,22,43,normal,2
2015-10-30 00:30:00,13,3,0,39,55,normal,2
2015-10-30 00:45:00,12,0,0,24,36,normal,2
2015-10-30 01:00:00,10,3,1,12,26,low,1
2015-10-30 01:15:00,11,4,0,38,53,normal,2
2015-10-30 01:30:00,18,4,0,31,53,normal,2
2015-10-30 01:45:00,19,1,0,34,54,normal,2
2015-10-30 02:00:00,18,1,0,27,46,normal,2
2015-10-30 02:15:00,13,0,0,26,39,normal,2
2015-10-30 02:30:00,12,2,0,35,49,normal,2
2015-10-30 02:45:00,15,4,0,12,31,low,1
2015-10-30 03:00:00,10,5,0,33,48,normal,2
2015-10-30 03:15:00,14,0,0,15,29,normal,2
2015-10-30 03:30:00,16,0,0,16,32,normal,2
2015-10-30 03:45:00,15,3,1,26,45,normal,2
2015-10-30 04:00:00,20,4,0,34,58,normal,2
2015-10-30 04:15:00,82,20,10,11,123,normal,2
2015-10-30 04:30:00,99,7,3,6,115,normal,2
2015-10-30 04:45:00,74,29,9,4,116,normal,2
2015-10-30 05:00:00,94,1,1,14,110,normal,2
2015-10-30 05:15:00,63,12,10,17,102,normal,2
2015-10-30 05:30:00,101,4,3,12,120,normal,2
2015-10-30 05:45:00,106,9,3,10,128,normal,2
2015-10-30 06:00:00,112,15,24,1,152,normal,2
2015-10-30 06:15:00,148,26,25,0,199,heavy,4
2015-10-30 06:30:00,115,20,31,3,169,heavy,4
2015-10-30 06:45:00,125,11,24,0,160,normal,2
2015-10-30 07:00:00,140,38,38,0,216,heavy,4
2015-10-30 07:15:00,150,17,35,5,207,heavy,4
2015-10-30 07:30:00,149,11,42,2,204,heavy,4
2015-10-30 07:45:00,150,22,38,3,213,heavy,4
2015-10-30 08:00:00,147,32,25,4,208,heavy,4
2015-10-30 08:15:00,138,39,45,4,226,heavy,4
2015-10-30 08:30:00,149,16,49,1,215,heavy,4
2015-10-30 08:45:00,139,10,50,2,201,heavy,4
2015-10-30 09:00:00,109,25,49,2,185,heavy,4
2015-10-30 09:15:00,84,24,12,28,148,high,3
2015-10-30 09:30:00,38,8,6,5,57,low,1
2015-10-30 09:45:00,45,16,6,21,88,normal,2
2015-10-30 10:00:00,57,4,36,14,111,normal,2
2015-10-30 10:15:00,84,12,6,28,130,high,3
2015-10-30 10:30:00,55,25,33,21,134,high,3
2015-10-30 10:45:00,14,15,5,21,55,normal,2
2015-10-30 11:00:00,26,8,11,20,65,normal,2
2015-10-30 11:15:00,60,10,9,27,106,normal,2
2015-10-30 11:30:00,34,6,7,25,72,normal,2
2015-10-30 11:45:00,22,9,8,26,65,normal,2
2015-10-30 12:00:00,59,10,11,30,110,normal,2
2015-10-30 12:15:00,48,6,14,28,96,normal,2
2015-10-30 12:30:00,46,9,11,23,89,normal,2
2015-10-30 12:45:00,37,9,8,20,74,normal,2
2015-10-30 13:00:00,67,9,11,21,108,normal,2
2015-10-30 13:15:00,32,19,39,9,99,normal,2
2015-10-30 13:30:00,63,12,22,5,102,normal,2
2015-10-30 13:45:00,32,29,25,11,97,normal,2
2015-10-30 14:00:00,83,22,40,20,165,high,3
2015-10-30 14:15:00,40,14,31,19,104,normal,2
2015-10-30 14:30:00,101,22,39,19,181,heavy,4
2015-10-30 14:45:00,62,29,31,11,133,high,3
2015-10-30 15:00:00,20,19,25,8,72,normal,2
2015-10-30 15:15:00,42,22,5,9,78,low,1
2015-10-30 15:30:00,37,17,12,16,82,normal,2
2015-10-30 15:45:00,95,12,20,15,142,normal,2
2015-10-30 16:00:00,137,14,41,10,202,heavy,4
2015-10-30 16:15:00,122,21,20,10,173,heavy,4
2015-10-30 16:30:00,104,19,39,9,171,heavy,4
2015-10-30 16:45:00,147,21,40,9,217,heavy,4
2015-10-30 17:00:00,105,38,34,7,184,heavy,4
2015-10-30 17:15:00,124,23,46,5,198,heavy,4
2015-10-30 17:30:00,135,18,20,5,178,heavy,4
2015-10-30 17:45:00,107,35,23,8,173,heavy,4
2015-10-30 18:00:00,109,21,24,10,164,normal,2
2015-10-30 18:15:00,136,32,26,8,202,heavy,4
2015-10-30 18:30:00,134,23,49,8,214,heavy,4
2015-10-30 18:45:00,90,20,11,25,146,high,3
2015-10-30 19:00:00,104,5,16,16,141,normal,2
2015-10-30 19:15:00,60,21,13,6,100,low,1
2015-10-30 19:30:00,104,22,11,13,150,normal,2
2015-10-30 19:45:00,54,23,10,25,112,high,3
2015-10-30 20:00:00,68,6,15,34,123,high,3
2015-10-30 20:15:00,88,13,19,19,139,normal,2
2015-10-30 20:30:00,64,22,16,16,118,normal,2
2015-10-30 20:45:00,58,24,14,24,120,high,3
2015-10-30 21:00:00,67,19,12,9,107,low,1
2015-10-30 21:15:00,73,20,18,7,118,normal,2
2015-10-30 21:30:00,109,25,16,20,170,heavy,4
2015-10-30 21:45:00,63,15,11,23,112,high,3
2015-10-30 22:00:00,19,4,1,26,50,normal,2
2015-10-30 22:15:00,15,1,0,34,50,normal,2
2015-10-30 22:30:00,15,5,1,14,35,normal,2
2015-10-30 22:45:00,19,3,1,33,56,normal,2
2015-10-30 23:00:00,18,4,0,11,33,low,1
2015-10-30 23:15:00,14,1,0,27,42,normal,2
2015-10-30 23:30:00,19,0,0,37,56,normal,2
2015-10-30 23:45:00,19,0,0,29,48,normal,2
2015-10-31 00:00:00,18,1,0,30,49,normal,2
2015-10-31 00:15:00,19,3,0,18,40,normal,2
2015-10-31 00:30:00,15,2,1,34,52,normal,2
2015-10-31 00:45:00,17,0,1,14,32,normal,2
2015-10-31 01:00:00,12,0,0,33,45,normal,2
2015-10-31 01:15:00,20,0,1,20,41,normal,2
2015-10-31 01:30:00,10,2,0,18,30,normal,2
2015-10-31 01:45:00,13,3,0,31,47,normal,2
2015-10-31 02:00:00,10,0,1,38,49,normal,2
2015-10-31 02:15:00,19,1,1,28,49,normal,2
2015-10-31 02:30:00,19,4,0,16,39,normal,2
2015-10-31 02:45:00,16,1,0,15,32,normal,2
2015-10-31 03:00:00,17,1,0,34,52,normal,2
2015-10-31 03:15:00,19,1,0,21,41,normal,2
2015-10-31 03:30:00,10,1,0,39,50,normal,2
2015-10-31 03:45:00,16,4,0,15,35,normal,2
2015-10-31 04:00:00,13,0,0,16,29,normal,2
2015-10-31 04:15:00,98,5,1,17,121,normal,2
2015-10-31 04:30:00,65,10,3,8,86,low,1
2015-10-31 04:45:00,98,17,0,20,135,normal,2
2015-10-31 05:00:00,60,20,5,6,91,low,1
2015-10-31 05:15:00,110,18,10,11,149,normal,2
2015-10-31 05:30:00,70,13,4,13,100,normal,2
2015-10-31 05:45:00,96,12,7,17,132,normal,2
2015-10-31 06:00:00,129,31,36,1,197,heavy,4
2015-10-31 06:15:00,146,28,47,3,224,heavy,4
2015-10-31 06:30:00,137,23,27,0,187,heavy,4
2015-10-31 06:45:00,131,28,24,0,183,heavy,4
2015-10-31 07:00:00,134,10,44,0,188,heavy,4
2015-10-31 07:15:00,109,25,24,0,158,normal,2
2015-10-31 07:30:00,108,35,22,3,168,heavy,4
2015-10-31 07:45:00,146,14,37,2,199,heavy,4
2015-10-31 08:00:00,147,21,41,5,214,heavy,4
2015-10-31 08:15:00,110,34,35,0,179,heavy,4
2015-10-31 08:30:00,110,40,50,2,202,heavy,4
2015-10-31 08:45:00,123,12,22,3,160,normal,2
2015-10-31 09:00:00,145,25,20,5,195,heavy,4
2015-10-31 09:15:00,82,15,16,29,142,high,3
2015-10-31 09:30:00,62,2,7,22,93,normal,2
2015-10-31 09:45:00,92,8,11,21,132,high,3
2015-10-31 10:00:00,35,22,22,18,97,normal,2
2015-10-31 10:15:00,66,25,13,13,117,normal,2
2015-10-31 10:30:00,50,2,25,12,89,normal,2
2015-10-31 10:45:00,50,22,24,7,103,normal,2
2015-10-31 11:00:00,50,8,5,24,87,normal,2
2015-10-31 11:15:00,55,5,5,21,86,normal,2
2015-10-31 11:30:00,51,10,14,24,99,normal,2
2015-10-31 11:45:00,34,8,14,21,77,normal,2
2015-10-31 12:00:00,25,7,5,20,57,normal,2
2015-10-31 12:15:00,59,7,9,21,96,normal,2
2015-10-31 12:30:00,38,10,9,24,81,normal,2
2015-10-31 12:45:00,70,10,9,23,112,high,3
2015-10-31 13:00:00,63,8,13,22,106,normal,2
2015-10-31 13:15:00,6,24,12,13,55,normal,2
2015-10-31 13:30:00,108,17,16,16,157,normal,2
2015-10-31 13:45:00,41,20,32,12,105,normal,2
2015-10-31 14:00:00,54,10,20,9,93,normal,2
2015-10-31 14:15:00,60,19,14,7,100,low,1
2015-10-31 14:30:00,102,11,9,11,133,normal,2
2015-10-31 14:45:00,50,24,30,5,109,normal,2
2015-10-31 15:00:00,25,24,19,10,78,normal,2
2015-10-31 15:15:00,90,25,18,20,153,normal,2
2015-10-31 15:30:00,86,13,27,11,137,high,3
2015-10-31 15:45:00,44,19,17,9,89,normal,2
2015-10-31 16:00:00,126,24,35,8,193,heavy,4
2015-10-31 16:15:00,146,26,42,9,223,normal,2
2015-10-31 16:30:00,117,28,33,10,188,heavy,4
2015-10-31 16:45:00,144,36,49,10,239,heavy,4
2015-10-31 17:00:00,137,19,23,9,188,heavy,4
2015-10-31 17:15:00,118,19,48,5,190,heavy,4
2015-10-31 17:30:00,119,27,28,8,182,heavy,4
2015-10-31 17:45:00,149,26,43,5,223,normal,2
2015-10-31 18:00:00,117,34,36,10,197,heavy,4
2015-10-31 18:15:00,124,30,44,10,208,heavy,4
2015-10-31 18:30:00,141,36,48,5,230,heavy,4
2015-10-31 18:45:00,78,6,11,28,123,high,3
2015-10-31 19:00:00,102,23,16,24,165,high,3
2015-10-31 19:15:00,104,18,18,23,163,high,3
2015-10-31 19:30:00,95,9,19,7,130,normal,2
2015-10-31 19:45:00,105,13,12,20,150,normal,2
2015-10-31 20:00:00,100,18,16,34,168,heavy,4
2015-10-31 20:15:00,80,14,20,15,129,normal,2
2015-10-31 20:30:00,86,8,19,7,120,normal,2
2015-10-31 20:45:00,108,20,14,15,157,normal,2
2015-10-31 21:00:00,69,13,13,8,103,low,1
2015-10-31 21:15:00,64,14,10,6,94,low,1
2015-10-31 21:30:00,71,14,17,10,112,normal,2
2015-10-31 21:45:00,61,9,18,24,112,high,3
2015-10-31 22:00:00,11,4,0,31,46,normal,2
2015-10-31 22:15:00,17,5,0,14,36,normal,2
2015-10-31 22:30:00,15,5,0,18,38,normal,2
2015-10-31 22:45:00,14,2,0,40,56,normal,2
2015-10-31 23:00:00,12,2,1,28,43,normal,2
2015-10-31 23:15:00,18,0,1,40,59,normal,2
2015-10-31 23:30:00,14,5,0,13,32,normal,2
2015-10-31 23:45:00,18,1,0,26,45,normal,2
2015-10-01 00:00:00,14,0,0,34,48,normal,2
2015-10-01 00:15:00,17,5,0,23,45,normal,2
2015-10-01 00:30:00,19,1,1,18,39,normal,2
2015-10-01 00:45:00,15,5,1,12,33,low,1
2015-10-01 01:00:00,13,2,1,26,42,normal,2
2015-10-01 01:15:00,15,3,0,32,50,normal,2
2015-10-01 01:30:00,15,0,1,13,29,normal,2
2015-10-01 01:45:00,18,5,1,12,36,low,1
2015-10-01 02:00:00,17,1,0,29,47,normal,2
2015-10-01 02:15:00,10,4,0,19,33,normal,2
2015-10-01 02:30:00,15,0,0,18,33,normal,2
2015-10-01 02:45:00,11,0,0,35,46,normal,2
2015-10-01 03:00:00,20,5,1,34,60,normal,2
2015-10-01 03:15:00,15,5,1,32,53,normal,2
2015-10-01 03:30:00,16,4,1,37,58,normal,2
2015-10-01 03:45:00,14,1,0,12,27,low,1
2015-10-01 04:00:00,16,4,0,18,38,normal,2
2015-10-01 04:15:00,56,21,3,0,80,low,1
2015-10-01 04:30:00,78,11,10,18,117,normal,2
2015-10-01 04:45:00,82,29,0,20,131,normal,2
2015-10-01 05:00:00,102,15,2,7,126,normal,2
2015-10-01 05:15:00,69,14,6,18,107,normal,2
2015-10-01 05:30:00,87,24,6,19,136,normal,2
2015-10-01 05:45:00,84,16,10,5,115,normal,2
2015-10-01 06:00:00,109,38,34,5,186,heavy,4
2015-10-01 06:15:00,147,38,23,3,211,heavy,4
2015-10-01 06:30:00,135,19,48,5,207,heavy,4
2015-10-01 06:45:00,101,23,41,5,170,heavy,4
2015-10-01 07:00:00,138,21,28,1,188,heavy,4
2015-10-01 07:15:00,136,20,32,1,189,heavy,4
2015-10-01 07:30:00,123,19,25,5,172,heavy,4
2015-10-01 07:45:00,108,30,46,5,189,heavy,4
2015-10-01 08:00:00,128,15,43,5,191,heavy,4
2015-10-01 08:15:00,129,37,41,1,208,heavy,4
2015-10-01 08:30:00,127,18,28,3,176,heavy,4
2015-10-01 08:45:00,142,37,46,3,228,heavy,4
2015-10-01 09:00:00,149,26,46,1,222,heavy,4
2015-10-01 09:15:00,77,13,7,23,120,high,3
2015-10-01 09:30:00,37,16,13,29,95,normal,2
2015-10-01 09:45:00,79,8,16,12,115,normal,2
2015-10-01 10:00:00,97,2,16,7,122,normal,2
2015-10-01 10:15:00,22,8,31,8,69,normal,2
2015-10-01 10:30:00,31,23,19,12,85,normal,2
2015-10-01 10:45:00,49,22,16,5,92,normal,2
2015-10-01 11:00:00,32,5,3,21,61,normal,2
2015-10-01 11:15:00,40,6,11,28,85,normal,2
2015-10-01 11:30:00,42,6,10,21,79,normal,2
2015-10-01 11:45:00,37,9,7,25,78,normal,2
2015-10-01 12:00:00,45,5,5,24,79,normal,2
2015-10-01 12:15:00,64,10,4,28,106,normal,2
2015-10-01 12:30:00,33,8,6,23,70,normal,2
2015-10-01 12:45:00,34,6,12,27,79,normal,2
2015-10-01 13:00:00,40,9,5,20,74,normal,2
2015-10-01 13:15:00,64,19,22,12,117,normal,2
2015-10-01 13:30:00,108,24,34,7,173,heavy,4
2015-10-01 13:45:00,108,17,33,7,165,high,3
2015-10-01 14:00:00,50,23,21,11,105,normal,2
2015-10-01 14:15:00,16,21,10,16,63,normal,2
2015-10-01 14:30:00,91,22,34,8,155,high,3
2015-10-01 14:45:00,89,19,37,18,163,high,3
2015-10-01 15:00:00,108,12,23,8,151,normal,2
2015-10-01 15:15:00,73,29,23,7,132,normal,2
2015-10-01 15:30:00,76,28,39,14,157,high,3
2015-10-01 15:45:00,19,15,20,17,71,normal,2
2015-10-01 16:00:00,102,37,48,9,196,heavy,4
2015-10-01 16:15:00,115,36,41,8,200,heavy,4
2015-10-01 16:30:00,142,23,23,6,194,heavy,4
2015-10-01 16:45:00,134,15,29,8,186,heavy,4
2015-10-01 17:00:00,146,18,49,9,222,heavy,4
2015-10-01 17:15:00,126,24,48,9,207,heavy,4
2015-10-01 17:30:00,138,18,27,6,189,heavy,4
2015-10-01 17:45:00,129,13,43,6,191,heavy,4
2015-10-01 18:00:00,127,35,23,10,195,heavy,4
2015-10-01 18:15:00,144,20,22,7,193,heavy,4
2015-10-01 18:30:00,117,19,31,7,174,heavy,4
2015-10-01 18:45:00,87,10,13,16,126,normal,2
2015-10-01 19:00:00,87,6,18,30,141,high,3
2015-10-01 19:15:00,97,18,10,24,149,high,3
2015-10-01 19:30:00,71,21,14,12,118,normal,2
2015-10-01 19:45:00,96,24,18,10,148,normal,2
2015-10-01 20:00:00,90,7,17,31,145,high,3
2015-10-01 20:15:00,74,6,12,34,126,high,3
2015-10-01 20:30:00,59,7,15,20,101,normal,2
2015-10-01 20:45:00,87,11,16,28,142,high,3
2015-10-01 21:00:00,62,22,20,20,124,normal,2
2015-10-01 21:15:00,71,16,14,9,110,low,1
2015-10-01 21:30:00,98,9,15,18,140,normal,2
2015-10-01 21:45:00,93,8,10,16,127,normal,2
2015-10-01 22:00:00,17,4,0,36,57,normal,2
2015-10-01 22:15:00,16,1,1,29,47,normal,2
2015-10-01 22:30:00,15,2,0,10,27,low,1
2015-10-01 22:45:00,10,3,1,23,37,normal,2
2015-10-01 23:00:00,12,4,0,31,47,normal,2
2015-10-01 23:15:00,20,1,1,24,46,normal,2
2015-10-01 23:30:00,11,0,1,23,35,normal,2
2015-10-01 23:45:00,14,1,1,17,33,normal,2
2015-10-02 00:00:00,12,5,1,38,56,normal,2
2015-10-02 00:15:00,15,4,1,29,49,normal,2
2015-10-02 00:30:00,12,4,0,40,56,normal,2
2015-10-02 00:45:00,11,5,0,22,38,normal,2
2015-10-02 01:00:00,14,5,1,21,41,normal,2
2015-10-02 01:15:00,14,3,0,39,56,normal,2
2015-10-02 01:30:00,10,4,1,11,26,low,1
2015-10-02 01:45:00,11,0,0,16,27,normal,2
2015-10-02 02:00:00,12,3,0,39,54,normal,2
2015-10-02 02:15:00,11,0,1,36,48,normal,2
2015-10-02 02:30:00,16,2,0,35,53,normal,2
2015-10-02 02:45:00,17,3,1,36,57,normal,2
2015-10-02 03:00:00,13,1,1,13,28,normal,2
2015-10-02 03:15:00,14,5,0,19,38,normal,2
2015-10-02 03:30:00,17,5,1,15,38,normal,2
2015-10-02 03:45:00,19,3,0,13,35,normal,2
2015-10-02 04:00:00,19,3,1,12,35,low,1
2015-10-02 04:15:00,54,15,10,8,87,low,1
2015-10-02 04:30:00,107,0,1,2,110,low,1
2015-10-02 04:45:00,116,20,5,14,155,normal,2
2015-10-02 05:00:00,78,2,4,9,93,low,1
2015-10-02 05:15:00,111,22,0,12,145,normal,2
2015-10-02 05:30:00,85,27,7,17,136,normal,2
2015-10-02 05:45:00,95,5,9,20,129,normal,2
2015-10-02 06:00:00,143,33,27,1,204,heavy,4
2015-10-02 06:15:00,133,40,37,0,210,heavy,4
2015-10-02 06:30:00,123,37,34,4,198,heavy,4
2015-10-02 06:45:00,133,34,36,1,204,heavy,4
2015-10-02 07:00:00,101,20,42,4,167,normal,2
2015-10-02 07:15:00,145,10,37,0,192,heavy,4
2015-10-02 07:30:00,141,39,40,5,225,heavy,4
2015-10-02 07:45:00,134,12,22,2,170,heavy,4
2015-10-02 08:00:00,126,10,26,4,166,high,3
2015-10-02 08:15:00,136,22,31,0,189,heavy,4
2015-10-02 08:30:00,128,26,42,4,200,heavy,4
2015-10-02 08:45:00,106,12,28,4,150,high,3
2015-10-02 09:00:00,140,27,36,2,205,heavy,4
2015-10-02 09:15:00,40,20,37,28,125,high,3
2015-10-02 09:30:00,13,25,33,12,83,normal,2
2015-10-02 09:45:00,18,22,26,10,76,normal,2
2015-10-02 10:00:00,59,5,36,12,112,high,3
2015-10-02 10:15:00,48,9,30,14,101,normal,2
2015-10-02 10:30:00,77,23,14,20,134,normal,2
2015-10-02 10:45:00,17,13,13,27,70,normal,2
2015-10-02 11:00:00,36,5,14,25,80,normal,2
2015-10-02 11:15:00,60,10,3,28,101,normal,2
2015-10-02 11:30:00,34,5,4,29,72,normal,2
2015-10-02 11:45:00,63,5,6,20,94,normal,2
2015-10-02 12:00:00,48,10,13,23,94,normal,2
2015-10-02 12:15:00,44,5,5,21,75,normal,2
2015-10-02 12:30:00,62,5,14,23,104,normal,2
2015-10-02 12:45:00,38,8,15,27,88,normal,2
2015-10-02 13:00:00,26,6,9,29,70,normal,2
2015-10-02 13:15:00,78,23,16,13,130,normal,2
2015-10-02 13:30:00,116,21,22,17,176,heavy,4
2015-10-02 13:45:00,94,13,11,16,134,normal,2
2015-10-02 14:00:00,52,19,26,10,107,normal,2
2015-10-02 14:15:00,70,13,12,10,105,low,1
2015-10-02 14:30:00,34,17,21,14,86,normal,2
2015-10-02 14:45:00,16,18,40,6,80,normal,2
2015-10-02 15:00:00,24,20,15,17,76,normal,2
2015-10-02 15:15:00,21,15,33,12,81,normal,2
2015-10-02 15:30:00,100,10,18,7,135,normal,2
2015-10-02 15:45:00,117,22,11,5,155,normal,2
2015-10-02 16:00:00,145,30,40,8,223,normal,2
2015-10-02 16:15:00,113,38,45,7,203,heavy,4
2015-10-02 16:30:00,110,31,37,7,185,heavy,4
2015-10-02 16:45:00,126,15,26,6,173,heavy,4
2015-10-02 17:00:00,100,15,29,7,151,high,3
2015-10-02 17:15:00,147,28,29,10,214,heavy,4
2015-10-02 17:30:00,146,22,50,10,228,heavy,4
2015-10-02 17:45:00,148,23,27,5,203,heavy,4
2015-10-02 18:00:00,149,17,41,9,216,heavy,4
2015-10-02 18:15:00,136,32,41,7,216,heavy,4
2015-10-02 18:30:00,101,22,33,9,165,high,3
2015-10-02 18:45:00,87,18,13,34,152,high,3
2015-10-02 19:00:00,50,21,14,9,94,low,1
2015-10-02 19:15:00,63,23,19,34,139,high,3
2015-10-02 19:30:00,73,9,11,5,98,low,1
2015-10-02 19:45:00,78,13,20,25,136,high,3
2015-10-02 20:00:00,71,22,12,14,119,normal,2
2015-10-02 20:15:00,80,17,11,15,123,normal,2
2015-10-02 20:30:00,62,21,10,35,128,high,3
2015-10-02 20:45:00,100,17,16,33,166,high,3
2015-10-02 21:00:00,95,15,18,9,137,normal,2
2015-10-02 21:15:00,102,14,15,34,165,high,3
2015-10-02 21:30:00,68,12,15,32,127,high,3
2015-10-02 21:45:00,74,5,19,5,103,normal,2
2015-10-02 22:00:00,15,4,1,21,41,normal,2
2015-10-02 22:15:00,16,0,1,24,41,normal,2
2015-10-02 22:30:00,12,0,0,12,24,low,1
2015-10-02 22:45:00,12,5,0,23,40,normal,2
2015-10-02 23:00:00,15,2,1,14,32,normal,2
2015-10-02 23:15:00,10,3,0,23,36,normal,2
2015-10-02 23:30:00,16,2,0,35,53,normal,2
2015-10-02 23:45:00,13,3,0,22,38,normal,2
2015-10-03 00:00:00,13,0,0,32,45,normal,2
2015-10-03 00:15:00,11,1,0,27,39,normal,2
2015-10-03 00:30:00,17,1,0,32,50,normal,2
2015-10-03 00:45:00,11,2,0,17,30,normal,2
2015-10-03 01:00:00,14,1,1,11,27,low,1
2015-10-03 01:15:00,17,2,0,33,52,normal,2
2015-10-03 01:30:00,15,2,1,38,56,normal,2
2015-10-03 01:45:00,13,4,1,24,42,normal,2
2015-10-03 02:00:00,11,5,1,11,28,low,1
2015-10-03 02:15:00,12,3,0,22,37,normal,2
2015-10-03 02:30:00,15,1,0,26,42,normal,2
2015-10-03 02:45:00,13,0,1,34,48,normal,2
2015-10-03 03:00:00,17,5,0,15,37,normal,2
2015-10-03 03:15:00,20,3,1,26,50,normal,2
2015-10-03 03:30:00,18,4,0,30,52,normal,2
2015-10-03 03:45:00,12,1,1,19,33,normal,2
2015-10-03 04:00:00,20,0,0,12,32,low,1
2015-10-03 04:15:00,29,10,0,12,51,low,1
2015-10-03 04:30:00,39,20,1,10,70,low,1
2015-10-03 04:45:00,76,9,7,13,105,normal,2
2015-10-03 05:00:00,33,17,0,13,63,normal,2
2015-10-03 05:15:00,64,14,1,12,91,low,1
2015-10-03 05:30:00,44,7,1,11,63,low,1
2015-10-03 05:45:00,53,8,4,15,80,normal,2
2015-10-03 06:00:00,75,6,7,13,101,normal,2
2015-10-03 06:15:00,60,11,4,10,85,low,1
2015-10-03 06:30:00,35,14,2,14,65,normal,2
2015-10-03 06:45:00,75,20,6,15,116,normal,2
2015-10-03 07:00:00,27,10,2,12,51,low,1
2015-10-03 07:15:00,61,20,7,14,102,normal,2
2015-10-03 07:30:00,72,20,5,15,112,normal,2
2015-10-03 07:45:00,43,18,6,14,81,normal,2
2015-10-03 08:00:00,54,10,4,14,82,normal,2
2015-10-03 08:15:00,30,12,1,14,57,normal,2
2015-10-03 08:30:00,72,8,6,12,98,low,1
2015-10-03 08:45:00,55,17,7,15,94,normal,2
2015-10-03 09:00:00,36,20,0,13,69,normal,2
2015-10-03 09:15:00,168,55,10,0,233,heavy,4
2015-10-03 09:30:00,135,61,28,2,226,heavy,4
2015-10-03 09:45:00,168,68,27,2,265,heavy,4
2015-10-03 10:00:00,139,44,16,1,200,heavy,4
2015-10-03 10:15:00,156,63,12,3,234,heavy,4
2015-10-03 10:30:00,141,51,27,3,222,heavy,4
2015-10-03 10:45:00,144,44,16,3,207,heavy,4
2015-10-03 11:00:00,132,65,23,0,220,heavy,4
2015-10-03 11:15:00,180,48,17,2,247,heavy,4
2015-10-03 11:30:00,140,67,20,4,231,heavy,4
2015-10-03 11:45:00,163,62,12,0,237,heavy,4
2015-10-03 12:00:00,148,70,15,0,233,heavy,4
2015-10-03 12:15:00,134,47,22,3,206,heavy,4
2015-10-03 12:30:00,162,51,13,0,226,heavy,4
2015-10-03 12:45:00,136,49,15,1,201,heavy,4
2015-10-03 13:00:00,147,52,26,0,225,heavy,4
2015-10-03 13:15:00,174,54,25,1,254,heavy,4
2015-10-03 13:30:00,135,69,20,1,225,heavy,4
2015-10-03 13:45:00,142,55,21,1,219,heavy,4
2015-10-03 14:00:00,144,59,14,2,219,heavy,4
2015-10-03 14:15:00,180,49,17,0,246,heavy,4
2015-10-03 14:30:00,153,59,20,4,236,heavy,4
2015-10-03 14:45:00,139,43,27,3,212,heavy,4
2015-10-03 15:00:00,179,60,12,0,251,heavy,4
2015-10-03 15:15:00,76,21,6,1,104,low,1
2015-10-03 15:30:00,59,25,19,1,104,normal,2
2015-10-03 15:45:00,51,20,12,1,84,low,1
2015-10-03 16:00:00,78,24,19,2,123,normal,2
2015-10-03 16:15:00,50,24,11,0,85,low,1
2015-10-03 16:30:00,59,25,8,0,92,low,1
2015-10-03 16:45:00,90,21,0,0,111,low,1
2015-10-03 17:00:00,79,26,21,2,128,normal,2
2015-10-03 17:15:00,56,21,4,1,82,low,1
2015-10-03 17:30:00,70,25,11,2,108,low,1
2015-10-03 17:45:00,54,27,21,2,104,normal,2
2015-10-03 18:00:00,53,22,13,2,90,low,1
2015-10-03 18:15:00,59,27,5,2,93,low,1
2015-10-03 18:30:00,63,30,21,0,114,normal,2
2015-10-03 18:45:00,87,21,16,0,124,normal,2
2015-10-03 19:00:00,71,26,19,1,117,normal,2
2015-10-03 19:15:00,32,5,5,13,55,normal,2
2015-10-03 19:30:00,36,6,7,2,51,low,1
2015-10-03 19:45:00,35,10,0,2,47,low,1
2015-10-03 20:00:00,40,10,5,10,65,low,1
2015-10-03 20:15:00,44,6,1,3,54,low,1
2015-10-03 20:30:00,40,6,1,3,50,low,1
2015-10-03 20:45:00,45,2,7,7,61,low,1
2015-10-03 21:00:00,44,2,6,5,57,low,1
2015-10-03 21:15:00,33,4,4,5,46,low,1
2015-10-03 21:30:00,22,5,3,13,43,normal,2
2015-10-03 21:45:00,33,5,5,1,44,low,1
2015-10-03 22:00:00,10,0,0,29,39,normal,2
2015-10-03 22:15:00,19,3,1,35,58,normal,2
2015-10-03 22:30:00,10,4,0,30,44,normal,2
2015-10-03 22:45:00,12,3,1,25,41,normal,2
2015-10-03 23:00:00,12,1,0,40,53,normal,2
2015-10-03 23:15:00,20,2,0,19,41,normal,2
2015-10-03 23:30:00,18,4,1,11,34,low,1
2015-10-03 23:45:00,19,1,1,37,58,normal,2
2015-10-04 00:00:00,13,2,0,25,40,normal,2
2015-10-04 00:15:00,16,4,1,15,36,normal,2
2015-10-04 00:30:00,10,4,1,16,31,normal,2
2015-10-04 00:45:00,18,3,0,19,40,normal,2
2015-10-04 01:00:00,15,5,0,10,30,low,1
2015-10-04 01:15:00,14,2,1,22,39,normal,2
2015-10-04 01:30:00,15,0,0,15,30,normal,2
2015-10-04 01:45:00,17,5,0,21,43,normal,2
2015-10-04 02:00:00,14,0,1,12,27,low,1
2015-10-04 02:15:00,10,1,0,11,22,low,1
2015-10-04 02:30:00,18,5,0,18,41,normal,2
2015-10-04 02:45:00,12,4,0,11,27,low,1
2015-10-04 03:00:00,17,0,1,30,48,normal,2
2015-10-04 03:15:00,20,1,0,28,49,normal,2
2015-10-04 03:30:00,19,5,1,38,63,normal,2
2015-10-04 03:45:00,15,0,0,36,51,normal,2
2015-10-04 04:00:00,10,2,0,30,42,normal,2
2015-10-04 04:15:00,74,4,4,13,95,normal,2
2015-10-04 04:30:00,96,29,6,17,148,normal,2
2015-10-04 04:45:00,109,16,6,12,143,normal,2
2015-10-04 05:00:00,113,6,9,10,138,normal,2
2015-10-04 05:15:00,90,24,8,20,142,normal,2
2015-10-04 05:30:00,106,19,10,17,152,normal,2
2015-10-04 05:45:00,96,7,6,4,113,normal,2
2015-10-04 06:00:00,102,21,42,3,168,heavy,4
2015-10-04 06:15:00,140,35,50,0,225,heavy,4
2015-10-04 06:30:00,105,33,29,4,171,heavy,4
2015-10-04 06:45:00,134,26,27,1,188,heavy,4
2015-10-04 07:00:00,123,35,45,1,204,heavy,4
2015-10-04 07:15:00,128,31,26,0,185,heavy,4
2015-10-04 07:30:00,105,32,43,0,180,heavy,4
2015-10-04 07:45:00,137,13,31,5,186,heavy,4
2015-10-04 08:00:00,148,37,46,2,233,heavy,4
2015-10-04 08:15:00,105,14,35,2,156,high,3
2015-10-04 08:30:00,148,17,42,5,212,heavy,4
2015-10-04 08:45:00,116,22,30,3,171,heavy,4
2015-10-04 09:00:00,143,28,46,1,218,heavy,4
2015-10-04 09:15:00,30,24,13,13,80,normal,2
2015-10-04 09:30:00,74,23,35,10,142,high,3
2015-10-04 09:45:00,67,5,36,17,125,high,3
2015-10-04 10:00:00,59,11,33,25,128,high,3
2015-10-04 10:15:00,34,21,39,16,110,normal,2
2015-10-04 10:30:00,72,24,10,9,115,normal,2
2015-10-04 10:45:00,73,12,32,5,122,high,3
2015-10-04 11:00:00,26,8,8,24,66,normal,2
2015-10-04 11:15:00,47,5,7,28,87,normal,2
2015-10-04 11:30:00,33,10,6,29,78,normal,2
2015-10-04 11:45:00,39,8,13,20,80,normal,2
2015-10-04 12:00:00,36,5,14,22,77,normal,2
2015-10-04 12:15:00,53,9,15,25,102,normal,2
2015-10-04 12:30:00,37,9,10,30,86,normal,2
2015-10-04 12:45:00,54,8,4,27,93,normal,2
2015-10-04 13:00:00,20,8,15,26,69,normal,2
2015-10-04 13:15:00,47,29,28,9,113,high,3
2015-10-04 13:30:00,51,27,10,20,108,normal,2
2015-10-04 13:45:00,114,11,40,20,185,heavy,4
2015-10-04 14:00:00,73,13,19,9,114,normal,2
2015-10-04 14:15:00,28,19,27,5,79,normal,2
2015-10-04 14:30:00,105,20,20,11,156,normal,2
2015-10-04 14:45:00,68,24,15,14,121,normal,2
2015-10-04 15:00:00,112,16,30,11,169,heavy,4
2015-10-04 15:15:00,120,30,28,15,193,heavy,4
2015-10-04 15:30:00,38,27,12,18,95,normal,2
2015-10-04 15:45:00,94,17,14,15,140,normal,2
2015-10-04 16:00:00,107,28,45,8,188,heavy,4
2015-10-04 16:15:00,100,16,49,7,172,heavy,4
2015-10-04 16:30:00,145,15,20,9,189,heavy,4
2015-10-04 16:45:00,133,17,22,8,180,heavy,4
2015-10-04 17:00:00,117,36,41,10,204,heavy,4
2015-10-04 17:15:00,113,26,26,8,173,heavy,4
2015-10-04 17:30:00,101,20,21,9,151,normal,2
2015-10-04 17:45:00,149,33,45,10,237,heavy,4
2015-10-04 18:00:00,134,35,26,7,202,heavy,4
2015-10-04 18:15:00,106,11,45,9,171,heavy,4
2015-10-04 18:30:00,121,37,34,6,198,heavy,4
2015-10-04 18:45:00,97,13,11,15,136,normal,2
2015-10-04 19:00:00,91,17,18,29,155,high,3
2015-10-04 19:15:00,57,16,13,19,105,normal,2
2015-10-04 19:30:00,110,10,10,20,150,normal,2
2015-10-04 19:45:00,71,14,17,30,132,high,3
2015-10-04 20:00:00,89,25,20,24,158,high,3
2015-10-04 20:15:00,87,16,15,14,132,normal,2
2015-10-04 20:30:00,106,12,16,9,143,normal,2
2015-10-04 20:45:00,78,10,19,20,127,normal,2
2015-10-04 21:00:00,61,10,16,27,114,high,3
2015-10-04 21:15:00,74,19,15,24,132,high,3
2015-10-04 21:30:00,56,20,11,25,112,high,3
2015-10-04 21:45:00,106,22,16,18,162,normal,2
2015-10-04 22:00:00,10,1,1,12,24,low,1
2015-10-04 22:15:00,12,4,1,33,50,normal,2
2015-10-04 22:30:00,16,4,0,16,36,normal,2
2015-10-04 22:45:00,18,1,0,18,37,normal,2
2015-10-04 23:00:00,19,2,0,36,57,normal,2
2015-10-04 23:15:00,18,4,1,35,58,normal,2
2015-10-04 23:30:00,17,0,0,31,48,normal,2
2015-10-04 23:45:00,18,1,0,16,35,normal,2
2015-10-05 00:00:00,15,4,0,37,56,normal,2
2015-10-05 00:15:00,11,5,0,14,30,normal,2
2015-10-05 00:30:00,11,5,0,22,38,normal,2
2015-10-05 00:45:00,12,2,1,37,52,normal,2
2015-10-05 01:00:00,18,1,1,34,54,normal,2
2015-10-05 01:15:00,19,1,0,11,31,low,1
2015-10-05 01:30:00,11,4,1,26,42,normal,2
2015-10-05 01:45:00,18,3,0,28,49,normal,2
2015-10-05 02:00:00,12,4,1,37,54,normal,2
2015-10-05 02:15:00,11,1,1,29,42,normal,2
2015-10-05 02:30:00,19,5,1,29,54,normal,2
2015-10-05 02:45:00,18,4,0,11,33,low,1
2015-10-05 03:00:00,16,4,0,29,49,normal,2
2015-10-05 03:15:00,19,4,1,33,57,normal,2
2015-10-05 03:30:00,15,3,1,12,31,low,1
2015-10-05 03:45:00,16,4,1,28,49,normal,2
2015-10-05 04:00:00,11,4,0,20,35,normal,2
2015-10-05 04:15:00,93,4,1,16,114,normal,2
2015-10-05 04:30:00,114,12,7,18,151,normal,2
2015-10-05 04:45:00,56,7,5,20,88,normal,2
2015-10-05 05:00:00,92,23,3,19,137,normal,2
2015-10-05 05:15:00,99,6,6,7,118,normal,2
2015-10-05 05:30:00,108,14,6,9,137,normal,2
2015-10-05 05:45:00,66,20,2,16,104,normal,2
2015-10-05 06:00:00,147,26,44,5,222,heavy,4
2015-10-05 06:15:00,139,27,29,1,196,heavy,4
2015-10-05 06:30:00,119,31,36,5,191,heavy,4
2015-10-05 06:45:00,114,30,21,2,167,normal,2
2015-10-05 07:00:00,103,27,21,4,155,normal,2
2015-10-05 07:15:00,105,17,29,4,155,high,3
2015-10-05 07:30:00,124,29,41,1,195,heavy,4
2015-10-05 07:45:00,118,19,34,1,172,heavy,4
2015-10-05 08:00:00,101,37,32,0,170,heavy,4
2015-10-05 08:15:00,109,11,48,1,169,heavy,4
2015-10-05 08:30:00,143,12,23,3,181,heavy,4
2015-10-05 08:45:00,143,40,30,0,213,heavy,4
2015-10-05 09:00:00,128,16,34,0,178,heavy,4
2015-10-05 09:15:00,14,25,14,16,69,normal,2
2015-10-05 09:30:00,99,10,11,15,135,normal,2
2015-10-05 09:45:00,67,1,22,14,104,normal,2
2015-10-05 10:00:00,42,2,29,9,82,normal,2
2015-10-05 10:15:00,92,3,33,21,149,high,3
2015-10-05 10:30:00,91,16,28,9,144,high,3
2015-10-05 10:45:00,25,9,10,28,72,normal,2
2015-10-05 11:00:00,37,5,12,29,83,normal,2
2015-10-05 11:15:00,55,6,12,29,102,normal,2
2015-10-05 11:30:00,49,8,8,26,91,normal,2
2015-10-05 11:45:00,69,9,3,20,101,normal,2
2015-10-05 12:00:00,38,6,6,24,74,normal,2
2015-10-05 12:15:00,40,8,12,21,81,normal,2
2015-10-05 12:30:00,53,5,3,20,81,normal,2
2015-10-05 12:45:00,21,8,4,28,61,normal,2
2015-10-05 13:00:00,24,7,4,20,55,normal,2
2015-10-05 13:15:00,47,24,24,9,104,normal,2
2015-10-05 13:30:00,90,30,32,8,160,high,3
2015-10-05 13:45:00,120,21,22,14,177,heavy,4
2015-10-05 14:00:00,120,12,40,13,185,heavy,4
2015-10-05 14:15:00,66,14,21,7,108,normal,2
2015-10-05 14:30:00,89,24,12,6,131,normal,2
2015-10-05 14:45:00,80,17,16,5,118,normal,2
2015-10-05 15:00:00,114,21,10,9,154,normal,2
2015-10-05 15:15:00,94,20,7,10,131,normal,2
2015-10-05 15:30:00,70,18,28,5,121,high,3
2015-10-05 15:45:00,56,17,15,8,96,low,1
2015-10-05 16:00:00,141,15,20,6,182,heavy,4
2015-10-05 16:15:00,150,19,46,7,222,heavy,4
2015-10-05 16:30:00,119,37,22,8,186,heavy,4
2015-10-05 16:45:00,144,14,44,5,207,heavy,4
2015-10-05 17:00:00,110,25,46,6,187,heavy,4
2015-10-05 17:15:00,138,15,31,10,194,heavy,4
2015-10-05 17:30:00,140,35,41,5,221,heavy,4
2015-10-05 17:45:00,103,24,28,8,163,high,3
2015-10-05 18:00:00,142,27,30,5,204,heavy,4
2015-10-05 18:15:00,149,13,22,9,193,heavy,4
2015-10-05 18:30:00,126,40,39,8,213,heavy,4
2015-10-05 18:45:00,78,15,14,28,135,high,3
2015-10-05 19:00:00,102,15,11,29,157,high,3
2015-10-05 19:15:00,96,22,20,12,150,normal,2
2015-10-05 19:30:00,110,24,15,14,163,normal,2
2015-10-05 19:45:00,97,22,17,13,149,normal,2
2015-10-05 20:00:00,53,19,11,18,101,normal,2
2015-10-05 20:15:00,82,8,17,29,136,high,3
2015-10-05 20:30:00,91,24,18,29,162,high,3
2015-10-05 20:45:00,102,6,14,35,157,high,3
2015-10-05 21:00:00,109,6,15,18,148,normal,2
2015-10-05 21:15:00,78,16,13,27,134,high,3
2015-10-05 21:30:00,66,12,16,33,127,high,3
2015-10-05 21:45:00,100,17,15,22,154,high,3
2015-10-05 22:00:00,15,1,1,25,42,normal,2
2015-10-05 22:15:00,16,1,0,33,50,normal,2
2015-10-05 22:30:00,19,4,0,26,49,normal,2
2015-10-05 22:45:00,10,0,1,34,45,normal,2
2015-10-05 23:00:00,14,0,0,28,42,normal,2
2015-10-05 23:15:00,13,2,0,22,37,normal,2
2015-10-05 23:30:00,18,5,1,20,44,normal,2
2015-10-05 23:45:00,18,4,0,18,40,normal,2
2015-10-06 00:00:00,11,3,0,26,40,normal,2
2015-10-06 00:15:00,13,1,0,24,38,normal,2
2015-10-06 00:30:00,19,5,1,15,40,normal,2
2015-10-06 00:45:00,11,3,1,28,43,normal,2
2015-10-06 01:00:00,11,1,1,40,53,normal,2
2015-10-06 01:15:00,18,4,1,28,51,normal,2
2015-10-06 01:30:00,15,2,1,16,34,normal,2
2015-10-06 01:45:00,20,0,0,27,47,normal,2
2015-10-06 02:00:00,14,5,0,17,36,normal,2
2015-10-06 02:15:00,11,3,1,10,25,low,1
2015-10-06 02:30:00,18,5,0,22,45,normal,2
2015-10-06 02:45:00,12,4,0,16,32,normal,2
2015-10-06 03:00:00,10,2,0,24,36,normal,2
2015-10-06 03:15:00,20,0,1,36,57,normal,2
2015-10-06 03:30:00,20,1,0,29,50,normal,2
2015-10-06 03:45:00,16,4,0,24,44,normal,2
2015-10-06 04:00:00,18,3,0,22,43,normal,2
2015-10-06 04:15:00,88,11,10,3,112,normal,2
2015-10-06 04:30:00,114,5,9,7,135,normal,2
2015-10-06 04:45:00,103,3,9,17,132,normal,2
2015-10-06 05:00:00,81,16,7,14,118,normal,2
2015-10-06 05:15:00,94,1,9,3,107,low,1
2015-10-06 05:30:00,56,11,9,15,91,normal,2
2015-10-06 05:45:00,80,16,5,10,111,low,1
2015-10-06 06:00:00,138,35,47,4,224,heavy,4
2015-10-06 06:15:00,123,27,22,4,176,heavy,4
2015-10-06 06:30:00,114,30,36,2,182,heavy,4
2015-10-06 06:45:00,122,30,37,2,191,heavy,4
2015-10-06 07:00:00,148,10,28,2,188,heavy,4
2015-10-06 07:15:00,127,38,48,0,213,heavy,4
2015-10-06 07:30:00,113,32,44,1,190,heavy,4
2015-10-06 07:45:00,131,26,40,1,198,heavy,4
2015-10-06 08:00:00,108,27,44,5,184,heavy,4
2015-10-06 08:15:00,109,19,49,3,180,heavy,4
2015-10-06 08:30:00,125,15,28,3,171,heavy,4
2015-10-06 08:45:00,139,30,35,4,208,heavy,4
2015-10-06 09:00:00,103,35,50,2,190,heavy,4
2015-10-06 09:15:00,64,13,40,12,129,high,3
2015-10-06 09:30:00,79,1,10,30,120,high,3
2015-10-06 09:45:00,50,2,7,14,73,normal,2
2015-10-06 10:00:00,84,18,18,28,148,high,3
2015-10-06 10:15:00,99,16,39,26,180,heavy,4
2015-10-06 10:30:00,42,3,27,18,90,normal,2
2015-10-06 10:45:00,53,2,29,24,108,normal,2
2015-10-06 11:00:00,63,10,8,28,109,normal,2
2015-10-06 11:15:00,24,8,3,20,55,normal,2
2015-10-06 11:30:00,46,8,6,26,86,normal,2
2015-10-06 11:45:00,20,7,8,26,61,normal,2
2015-10-06 12:00:00,41,8,7,27,83,normal,2
2015-10-06 12:15:00,44,5,3,28,80,normal,2
2015-10-06 12:30:00,33,6,14,28,81,normal,2
2015-10-06 12:45:00,30,9,7,25,71,normal,2
2015-10-06 13:00:00,68,7,5,25,105,normal,2
2015-10-06 13:15:00,28,29,26,5,88,normal,2
2015-10-06 13:30:00,96,20,14,18,148,normal,2
2015-10-06 13:45:00,24,15,26,13,78,normal,2
2015-10-06 14:00:00,70,21,32,18,141,high,3
2015-10-06 14:15:00,49,21,11,20,101,normal,2
2015-10-06 14:30:00,51,22,12,16,101,normal,2
2015-10-06 14:45:00,84,12,15,15,126,normal,2
2015-10-06 15:00:00,99,18,7,20,144,normal,2
2015-10-06 15:15:00,106,10,9,8,133,normal,2
2015-10-06 15:30:00,6,11,34,20,71,normal,2
2015-10-06 15:45:00,59,29,15,16,119,normal,2
2015-10-06 16:00:00,139,25,41,5,210,heavy,4
2015-10-06 16:15:00,109,12,49,6,176,heavy,4
2015-10-06 16:30:00,124,24,47,9,204,heavy,4
2015-10-06 16:45:00,135,29,39,7,210,heavy,4
2015-10-06 17:00:00,137,15,37,7,196,heavy,4
2015-10-06 17:15:00,119,28,46,9,202,heavy,4
2015-10-06 17:30:00,127,21,28,5,181,heavy,4
2015-10-06 17:45:00,109,37,44,9,199,heavy,4
2015-10-06 18:00:00,145,27,35,7,214,heavy,4
2015-10-06 18:15:00,133,36,28,6,203,heavy,4
2015-10-06 18:30:00,138,19,36,5,198,heavy,4
2015-10-06 18:45:00,73,5,20,10,108,normal,2
2015-10-06 19:00:00,83,11,14,33,141,high,3
2015-10-06 19:15:00,89,8,10,19,126,normal,2
2015-10-06 19:30:00,99,19,18,24,160,high,3
2015-10-06 19:45:00,54,17,14,8,93,low,1
2015-10-06 20:00:00,58,18,14,6,96,low,1
2015-10-06 20:15:00,56,16,12,9,93,low,1
2015-10-06 20:30:00,77,6,20,5,108,normal,2
2015-10-06 20:45:00,85,6,18,17,126,normal,2
2015-10-06 21:00:00,105,14,13,32,164,high,3
2015-10-06 21:15:00,96,21,11,24,152,high,3
2015-10-06 21:30:00,66,22,17,16,121,normal,2
2015-10-06 21:45:00,88,15,19,14,136,normal,2
2015-10-06 22:00:00,16,1,1,24,42,normal,2
2015-10-06 22:15:00,13,1,0,11,25,low,1
2015-10-06 22:30:00,13,5,1,23,42,normal,2
2015-10-06 22:45:00,19,5,0,37,61,normal,2
2015-10-06 23:00:00,19,1,0,31,51,normal,2
2015-10-06 23:15:00,11,5,0,19,35,normal,2
2015-10-06 23:30:00,18,3,0,32,53,normal,2
2015-10-06 23:45:00,17,1,1,38,57,normal,2
2015-10-07 00:00:00,17,3,0,20,40,normal,2
2015-10-07 00:15:00,18,4,1,19,42,normal,2
2015-10-07 00:30:00,19,3,0,24,46,normal,2
2015-10-07 00:45:00,16,3,0,15,34,normal,2
2015-10-07 01:00:00,12,5,1,21,39,normal,2
2015-10-07 01:15:00,17,3,0,36,56,normal,2
2015-10-07 01:30:00,19,4,1,21,45,normal,2
2015-10-07 01:45:00,13,5,0,20,38,normal,2
2015-10-07 02:00:00,14,0,1,37,52,normal,2
2015-10-07 02:15:00,14,5,0,39,58,normal,2
2015-10-07 02:30:00,13,1,0,19,33,normal,2
2015-10-07 02:45:00,18,5,1,25,49,normal,2
2015-10-07 03:00:00,15,1,1,15,32,normal,2
2015-10-07 03:15:00,19,2,0,30,51,normal,2
2015-10-07 03:30:00,18,2,1,27,48,normal,2
2015-10-07 03:45:00,13,1,0,38,52,normal,2
2015-10-07 04:00:00,19,2,0,32,53,normal,2
2015-10-07 04:15:00,116,0,1,9,126,normal,2
2015-10-07 04:30:00,60,12,8,15,95,normal,2
2015-10-07 04:45:00,82,15,0,19,116,normal,2
2015-10-07 05:00:00,67,23,7,3,100,low,1
2015-10-07 05:15:00,59,27,10,18,114,normal,2
2015-10-07 05:30:00,66,6,9,5,86,low,1
2015-10-07 05:45:00,120,10,3,16,149,normal,2
2015-10-07 06:00:00,121,22,30,0,173,heavy,4
2015-10-07 06:15:00,130,27,39,5,201,heavy,4
2015-10-07 06:30:00,139,31,44,3,217,heavy,4
2015-10-07 06:45:00,129,14,43,5,191,heavy,4
2015-10-07 07:00:00,131,28,43,5,207,heavy,4
2015-10-07 07:15:00,119,39,24,1,183,heavy,4
2015-10-07 07:30:00,142,25,34,5,206,heavy,4
2015-10-07 07:45:00,123,22,22,3,170,heavy,4
2015-10-07 08:00:00,106,19,38,4,167,normal,2
2015-10-07 08:15:00,115,39,20,2,176,heavy,4
2015-10-07 08:30:00,111,17,32,1,161,high,3
2015-10-07 08:45:00,144,26,50,3,223,normal,2
2015-10-07 09:00:00,126,31,48,2,207,heavy,4
2015-10-07 09:15:00,73,22,21,29,145,high,3
2015-10-07 09:30:00,28,7,25,18,78,normal,2
2015-10-07 09:45:00,31,10,40,9,90,normal,2
2015-10-07 10:00:00,51,14,33,14,112,high,3
2015-10-07 10:15:00,22,7,39,23,91,normal,2
2015-10-07 10:30:00,46,5,11,21,83,normal,2
2015-10-07 10:45:00,72,22,21,27,142,high,3
2015-10-07 11:00:00,70,5,5,29,109,normal,2
2015-10-07 11:15:00,28,9,9,24,70,normal,2
2015-10-07 11:30:00,44,5,11,23,83,normal,2
2015-10-07 11:45:00,27,6,13,30,76,normal,2
2015-10-07 12:00:00,20,6,6,23,55,normal,2
2015-10-07 12:15:00,29,7,3,28,67,normal,2
2015-10-07 12:30:00,20,6,5,27,58,normal,2
2015-10-07 12:45:00,65,9,15,22,111,normal,2
2015-10-07 13:00:00,36,5,6,20,67,normal,2
2015-10-07 13:15:00,99,21,21,6,147,normal,2
2015-10-07 13:30:00,101,21,34,18,174,heavy,4
2015-10-07 13:45:00,98,29,34,12,173,heavy,4
2015-10-07 14:00:00,113,20,7,13,153,normal,2
2015-10-07 14:15:00,75,24,27,7,133,high,3
2015-10-07 14:30:00,71,21,38,11,141,high,3
2015-10-07 14:45:00,119,13,32,7,171,heavy,4
2015-10-07 15:00:00,114,11,39,13,177,heavy,4
2015-10-07 15:15:00,99,26,8,11,144,normal,2
2015-10-07 15:30:00,39,12,21,9,81,normal,2
2015-10-07 15:45:00,114,26,16,20,176,heavy,4
2015-10-07 16:00:00,120,32,39,9,200,heavy,4
2015-10-07 16:15:00,143,24,35,6,208,heavy,4
2015-10-07 16:30:00,121,28,21,5,175,heavy,4
2015-10-07 16:45:00,134,23,28,10,195,heavy,4
2015-10-07 17:00:00,103,13,37,10,163,high,3
2015-10-07 17:15:00,122,12,48,10,192,heavy,4
2015-10-07 17:30:00,145,39,23,6,213,heavy,4
2015-10-07 17:45:00,105,13,48,10,176,heavy,4
2015-10-07 18:00:00,144,13,40,10,207,heavy,4
2015-10-07 18:15:00,103,18,40,5,166,high,3
2015-10-07 18:30:00,120,15,34,8,177,heavy,4
2015-10-07 18:45:00,56,19,16,13,104,normal,2
2015-10-07 19:00:00,56,5,17,14,92,normal,2
2015-10-07 19:15:00,108,15,13,5,141,normal,2
2015-10-07 19:30:00,58,23,14,34,129,high,3
2015-10-07 19:45:00,58,13,11,33,115,high,3
2015-10-07 20:00:00,76,24,14,15,129,normal,2
2015-10-07 20:15:00,69,8,13,28,118,high,3
2015-10-07 20:30:00,54,9,12,10,85,low,1
2015-10-07 20:45:00,89,7,10,10,116,normal,2
2015-10-07 21:00:00,110,18,18,10,156,normal,2
2015-10-07 21:15:00,86,12,17,18,133,normal,2
2015-10-07 21:30:00,82,7,16,9,114,normal,2
2015-10-07 21:45:00,102,5,19,11,137,normal,2
2015-10-07 22:00:00,16,5,0,21,42,normal,2
2015-10-07 22:15:00,11,3,1,39,54,normal,2
2015-10-07 22:30:00,18,5,0,11,34,low,1
2015-10-07 22:45:00,12,0,1,32,45,normal,2
2015-10-07 23:00:00,15,4,1,39,59,normal,2
2015-10-07 23:15:00,15,4,0,26,45,normal,2
2015-10-07 23:30:00,13,1,0,30,44,normal,2
2015-10-07 23:45:00,12,3,0,28,43,normal,2
2015-10-08 00:00:00,17,2,1,20,40,normal,2
2015-10-08 00:15:00,14,5,1,33,53,normal,2
2015-10-08 00:30:00,16,3,1,11,31,low,1
2015-10-08 00:45:00,18,2,1,13,34,normal,2
2015-10-08 01:00:00,12,2,1,17,32,normal,2
2015-10-08 01:15:00,17,4,1,15,37,normal,2
2015-10-08 01:30:00,18,1,1,25,45,normal,2
2015-10-08 01:45:00,20,1,1,10,32,low,1
2015-10-08 02:00:00,15,1,0,21,37,normal,2
2015-10-08 02:15:00,11,3,1,34,49,normal,2
2015-10-08 02:30:00,19,0,1,13,33,normal,2
2015-10-08 02:45:00,10,3,0,14,27,normal,2
2015-10-08 03:00:00,17,5,1,17,40,normal,2
2015-10-08 03:15:00,16,1,0,11,28,low,1
2015-10-08 03:30:00,11,0,1,33,45,normal,2
2015-10-08 03:45:00,10,5,0,39,54,normal,2
2015-10-08 04:00:00,12,3,0,32,47,normal,2
2015-10-08 04:15:00,106,16,10,10,142,normal,2
2015-10-08 04:30:00,69,18,0,12,99,low,1
2015-10-08 04:45:00,103,26,6,12,147,normal,2
2015-10-08 05:00:00,99,25,6,6,136,normal,2
2015-10-08 05:15:00,85,9,4,11,109,low,1
2015-10-08 05:30:00,109,0,3,8,120,normal,2
2015-10-08 05:45:00,106,27,1,6,140,normal,2
2015-10-08 06:00:00,133,28,31,3,195,heavy,4
2015-10-08 06:15:00,108,39,34,5,186,heavy,4
2015-10-08 06:30:00,101,12,48,1,162,high,3
2015-10-08 06:45:00,145,11,29,1,186,heavy,4
2015-10-08 07:00:00,112,33,29,3,177,heavy,4
2015-10-08 07:15:00,111,18,32,4,165,high,3
2015-10-08 07:30:00,133,39,44,2,218,heavy,4
2015-10-08 07:45:00,115,34,37,5,191,heavy,4
2015-10-08 08:00:00,135,35,38,3,211,heavy,4
2015-10-08 08:15:00,142,40,28,3,213,heavy,4
2015-10-08 08:30:00,124,11,27,2,164,high,3
2015-10-08 08:45:00,122,29,31,5,187,heavy,4
2015-10-08 09:00:00,101,19,23,5,148,normal,2
2015-10-08 09:15:00,72,5,15,20,112,normal,2
2015-10-08 09:30:00,100,13,23,9,145,normal,2
2015-10-08 09:45:00,32,10,33,8,83,normal,2
2015-10-08 10:00:00,42,25,37,12,116,high,3
2015-10-08 10:15:00,81,25,40,20,166,high,3
2015-10-08 10:30:00,56,18,9,23,106,normal,2
2015-10-08 10:45:00,84,9,31,17,141,high,3
2015-10-08 11:00:00,36,9,8,28,81,normal,2
2015-10-08 11:15:00,32,5,11,27,75,normal,2
2015-10-08 11:30:00,26,7,15,27,75,normal,2
2015-10-08 11:45:00,34,5,5,22,66,normal,2
2015-10-08 12:00:00,66,9,6,30,111,normal,2
2015-10-08 12:15:00,69,10,4,24,107,normal,2
2015-10-08 12:30:00,44,7,9,20,80,normal,2
2015-10-08 12:45:00,58,10,5,27,100,normal,2
2015-10-08 13:00:00,27,6,14,30,77,normal,2
2015-10-08 13:15:00,19,21,25,15,80,normal,2
2015-10-08 13:30:00,39,15,30,8,92,normal,2
2015-10-08 13:45:00,109,21,10,12,152,normal,2
2015-10-08 14:00:00,93,10,9,15,127,normal,2
2015-10-08 14:15:00,73,16,12,11,112,normal,2
2015-10-08 14:30:00,111,18,29,16,174,heavy,4
2015-10-08 14:45:00,37,20,10,19,86,normal,2
2015-10-08 15:00:00,74,23,13,20,130,normal,2
2015-10-08 15:15:00,32,28,35,6,101,normal,2
2015-10-08 15:30:00,34,23,19,17,93,normal,2
2015-10-08 15:45:00,59,25,9,20,113,normal,2
2015-10-08 16:00:00,145,12,24,8,189,heavy,4
2015-10-08 16:15:00,118,17,28,8,171,heavy,4
2015-10-08 16:30:00,145,20,47,8,220,heavy,4
2015-10-08 16:45:00,140,25,46,10,221,heavy,4
2015-10-08 17:00:00,120,35,43,7,205,heavy,4
2015-10-08 17:15:00,126,24,31,7,188,heavy,4
2015-10-08 17:30:00,106,22,43,5,176,heavy,4
2015-10-08 17:45:00,137,40,28,9,214,heavy,4
2015-10-08 18:00:00,108,40,25,6,179,heavy,4
2015-10-08 18:15:00,135,15,50,6,206,heavy,4
2015-10-08 18:30:00,121,21,49,8,199,heavy,4
2015-10-08 18:45:00,59,6,20,6,91,normal,2
2015-10-08 19:00:00,59,13,18,27,117,high,3
2015-10-08 19:15:00,103,7,15,15,140,normal,2
2015-10-08 19:30:00,56,14,14,31,115,high,3
2015-10-08 19:45:00,106,23,12,9,150,normal,2
2015-10-08 20:00:00,109,5,16,17,147,normal,2
2015-10-08 20:15:00,110,5,20,11,146,normal,2
2015-10-08 20:30:00,86,15,15,23,139,high,3
2015-10-08 20:45:00,91,18,19,26,154,high,3
2015-10-08 21:00:00,99,19,15,28,161,high,3
2015-10-08 21:15:00,93,14,20,17,144,normal,2
2015-10-08 21:30:00,89,25,13,23,150,high,3
2015-10-08 21:45:00,107,15,12,24,158,high,3
2015-10-08 22:00:00,16,5,0,14,35,normal,2
2015-10-08 22:15:00,14,5,1,20,40,normal,2
2015-10-08 22:30:00,18,3,0,24,45,normal,2
2015-10-08 22:45:00,12,3,0,40,55,normal,2
2015-10-08 23:00:00,14,4,1,27,46,normal,2
2015-10-08 23:15:00,18,5,1,15,39,normal,2
2015-10-08 23:30:00,10,4,1,23,38,normal,2
2015-10-08 23:45:00,10,5,0,14,29,normal,2
2015-10-09 00:00:00,14,3,0,28,45,normal,2
2015-10-09 00:15:00,10,2,0,38,50,normal,2
2015-10-09 00:30:00,19,0,0,32,51,normal,2
2015-10-09 00:45:00,20,3,0,19,42,normal,2
2015-10-09 01:00:00,18,3,0,14,35,normal,2
2015-10-09 01:15:00,11,2,0,12,25,low,1
2015-10-09 01:30:00,17,1,1,13,32,normal,2
2015-10-09 01:45:00,10,0,1,36,47,normal,2
2015-10-09 02:00:00,17,0,0,32,49,normal,2
2015-10-09 02:15:00,20,5,1,22,48,normal,2
2015-10-09 02:30:00,12,3,0,17,32,normal,2
2015-10-09 02:45:00,13,0,0,31,44,normal,2
2015-10-09 03:00:00,11,1,1,35,48,normal,2
2015-10-09 03:15:00,18,2,0,19,39,normal,2
2015-10-09 03:30:00,15,0,1,24,40,normal,2
2015-10-09 03:45:00,14,3,0,25,42,normal,2
2015-10-09 04:00:00,12,0,1,16,29,normal,2
2015-10-09 04:15:00,85,24,5,5,119,normal,2
2015-10-09 04:30:00,71,22,5,2,100,low,1
2015-10-09 04:45:00,108,4,5,3,120,normal,2
2015-10-09 05:00:00,63,29,5,15,112,normal,2
2015-10-09 05:15:00,62,12,3,18,95,normal,2
2015-10-09 05:30:00,118,15,3,11,147,normal,2
2015-10-09 05:45:00,90,21,2,14,127,normal,2
2015-10-09 06:00:00,141,30,31,1,203,heavy,4
2015-10-09 06:15:00,126,31,33,2,192,heavy,4
2015-10-09 06:30:00,112,26,30,4,172,heavy,4
2015-10-09 06:45:00,112,12,38,4,166,high,3
2015-10-09 07:00:00,144,14,33,4,195,heavy,4
2015-10-09 07:15:00,127,13,36,1,177,heavy,4
2015-10-09 07:30:00,146,10,44,5,205,heavy,4
2015-10-09 07:45:00,146,22,26,4,198,heavy,4
2015-10-09 08:00:00,101,10,48,5,164,high,3
2015-10-09 08:15:00,104,19,24,4,151,normal,2
2015-10-09 08:30:00,150,20,43,0,213,heavy,4
2015-10-09 08:45:00,110,35,45,2,192,heavy,4
2015-10-09 09:00:00,139,15,28,2,184,heavy,4
2015-10-09 09:15:00,99,17,32,7,155,high,3
2015-10-09 09:30:00,22,15,7,19,63,normal,2
2015-10-09 09:45:00,11,12,21,24,68,normal,2
2015-10-09 10:00:00,47,20,18,16,101,normal,2
2015-10-09 10:15:00,54,1,35,26,116,high,3
2015-10-09 10:30:00,26,16,13,16,71,normal,2
2015-10-09 10:45:00,99,18,39,19,175,heavy,4
2015-10-09 11:00:00,31,9,11,28,79,normal,2
2015-10-09 11:15:00,24,8,13,23,68,normal,2
2015-10-09 11:30:00,21,7,9,20,57,normal,2
2015-10-09 11:45:00,60,10,5,25,100,normal,2
2015-10-09 12:00:00,29,9,12,21,71,normal,2
2015-10-09 12:15:00,37,7,14,28,86,normal,2
2015-10-09 12:30:00,53,7,11,22,93,normal,2
2015-10-09 12:45:00,35,5,15,25,80,normal,2
2015-10-09 13:00:00,53,6,10,28,97,normal,2
2015-10-09 13:15:00,114,18,17,8,157,normal,2
2015-10-09 13:30:00,95,28,22,9,154,normal,2
2015-10-09 13:45:00,62,23,38,19,142,high,3
2015-10-09 14:00:00,70,28,12,12,122,normal,2
2015-10-09 14:15:00,35,20,10,8,73,low,1
2015-10-09 14:30:00,60,23,10,20,113,normal,2
2015-10-09 14:45:00,40,22,25,9,96,normal,2
2015-10-09 15:00:00,53,21,6,11,91,low,1
2015-10-09 15:15:00,99,16,38,7,160,high,3
2015-10-09 15:30:00,86,21,31,18,156,high,3
2015-10-09 15:45:00,79,28,35,13,155,high,3
2015-10-09 16:00:00,146,25,33,8,212,heavy,4
2015-10-09 16:15:00,116,24,36,6,182,heavy,4
2015-10-09 16:30:00,107,14,44,5,170,heavy,4
2015-10-09 16:45:00,115,20,27,9,171,heavy,4
2015-10-09 17:00:00,113,23,43,6,185,heavy,4
2015-10-09 17:15:00,102,20,31,5,158,high,3
2015-10-09 17:30:00,138,27,21,7,193,heavy,4
2015-10-09 17:45:00,146,13,38,9,206,heavy,4
2015-10-09 18:00:00,139,33,41,7,220,heavy,4
2015-10-09 18:15:00,130,24,48,9,211,heavy,4
2015-10-09 18:30:00,135,31,34,8,208,heavy,4
2015-10-09 18:45:00,106,22,16,20,164,normal,2
2015-10-09 19:00:00,109,23,14,26,172,heavy,4
2015-10-09 19:15:00,108,24,19,10,161,normal,2
2015-10-09 19:30:00,50,16,16,11,93,normal,2
2015-10-09 19:45:00,102,22,17,10,151,normal,2
2015-10-09 20:00:00,72,25,10,27,134,high,3
2015-10-09 20:15:00,91,13,18,13,135,normal,2
2015-10-09 20:30:00,67,19,11,8,105,low,1
2015-10-09 20:45:00,61,14,10,5,90,low,1
2015-10-09 21:00:00,107,13,14,28,162,high,3
2015-10-09 21:15:00,91,5,12,34,142,high,3
2015-10-09 21:30:00,106,18,13,27,164,high,3
2015-10-09 21:45:00,107,14,10,18,149,normal,2
2015-10-09 22:00:00,17,4,1,20,42,normal,2
2015-10-09 22:15:00,11,4,1,30,46,normal,2
2015-10-09 22:30:00,11,4,0,23,38,normal,2
2015-10-09 22:45:00,16,3,1,36,56,normal,2
2015-10-09 23:00:00,11,0,1,30,42,normal,2
2015-10-09 23:15:00,15,4,1,25,45,normal,2
2015-10-09 23:30:00,16,5,0,27,48,normal,2
2015-10-09 23:45:00,14,3,1,15,33,normal,2
